vg|BBO1-2015WBTC-VC,F4,I,17,32,FRANCE,96,USA2,96|
rs|1NN-2,1NN=,5DS=,3NS+3,5DW+1,5DWx+1,4HE-2,4HE-2,3NE+1,3NW+1,3NE+1,3NE+1,3SS-1,3SS+1,3NW-4,3HN-1,3NS+1,3NN=,1NN-1,2NS-1,4SS+2,4SS+1,4HWx=,4HW=,1NS-2,1NS-1,3NN+1,3NN=,4SN+2,4SN+1,4SS-2,4SS-2|
pn|WILLARD,SOKOLOW,CRONIER,SEAMON-MOL,DEAS,HUGON,PALMER,CAMPAGNANO|pg||
qx|o17|st||md|3SK52HT642DJ93CK63,SQ987HDQT875CAQJ9,SAJHAK73DK42CT752,ST643HQJ985DA6C84|sv|o|mb|1N|mb|p|mb|p|mb|p|pg||
pc|h8|pc|h2|pc|d5|pc|hA|pg||
pc|c2|pc|c4|pc|cK|pc|cA|pg||
pc|s9|pc|sJ|pc|s6|pc|s2|pg||
pc|c5|pc|c8|pc|c3|pc|c9|pg||
pc|cJ|pc|c7|pc|s3|pc|c6|pg||
pc|cQ|pc|cT|pc|h5|pc|d3|pg||
pc|s7|pc|sA|pc|s4|pc|s5|pg||
pc|h3|pc|hJ|pc|h4|pc|s8|pg||
pc|dA|pc|d9|pc|d7|pc|d2|pg||
pc|d6|pc|dJ|pc|dQ|pc|dK|pg||
pc|hK|pc|h9|pc|h6|pc|sQ|pg||
pc|d4|pc|sT|pc|hT|pc|d8|pg||
pc|dT|pc|h7|pc|hQ|pc|sK|pg||
pg||
qx|c17|st||md|3SK52HT642DJ93CK63,SQ987HDQT875CAQJ9,SAJHAK73DK42CT752,ST643HQJ985DA6C84|sv|o|mb|1N|mb|p|mb|p|mb|p|pg||
pc|hQ|pc|h2|pc|d5|pc|hA|pg||
pc|h3|pc|hJ|pc|h4|pc|s8|pg||
pc|dA|pc|d3|pc|d7|pc|d2|pg||
pc|d6|pc|d9|pc|dT|pc|dK|pg||
pc|h7|pc|h5|pc|hT|pc|c9|pg||
pc|h6|pc|d8|pc|hK|pc|h8|pg||
pc|c2|pc|c8|pc|cK|pc|cA|pg||
pc|dQ|pc|d4|pc|h9|pc|dJ|pg||
pc|s7|pc|sJ|pc|s3|pc|s2|pg||
pc|sA|pc|s4|pc|s5|pc|s9|pg||
pc|c5|pc|c4|pc|c3|pc|cJ|pg||
pc|cQ|pc|c7|pc|s6|pc|c6|pg||
pc|sQ|pc|cT|pc|sT|pc|sK|pg||
pg||
qx|o18|st||md|4SA97HQ5DAKQJ732C6,SJ42HA3DT85CKJ943,SKT63H762D964CAT7,SQ85HKJT984DCQ852|sv|n|mb|3H|mb|d|mb|p|mb|3S|mb|p|mb|4D|mb|p|mb|4H!|mb|p|mb|5D|mb|p|mb|p|mb|p|pg||
pc|hA|pc|h2|pc|h9|pc|hQ|pg||
pc|h3|pc|h6|pc|hK|pc|h5|pg||
pc|hT|pc|dA|pc|c3|pc|h7|pg||
pc|dK|pc|d5|pc|d4|pc|h4|pg||
pc|dJ|pc|d8|pc|d6|pc|h8|pg||
pc|dQ|pc|dT|pc|d9|pc|hJ|pg||
pc|c6|pc|cJ|pc|cA|pc|c2|pg||
pc|c7|pc|c5|pc|d2|pc|c4|pg||
pc|d7|pc|c9|pc|s3|pc|c8|pg||
pc|d3|pc|s2|pc|s6|pc|s5|pg||
pc|s7|pc|s4|pc|sK|pc|s8|pg||
pc|sT|pc|sQ|pc|sA|pc|sJ|pg||
pc|s9|pc|cK|pc|cT|pc|cQ|pg||
pg||
qx|c18|st||md|4SA97HQ5DAKQJ732C6,SJ42HA3DT85CKJ943,SKT63H762D964CAT7,SQ85HKJT984DCQ852|sv|n|mb|2D!|mb|3N|mb|p|mb|p|mb|p|pg||
pc|s2|pc|s3|pc|sQ|pc|sA|pg||
pc|dA|pc|d8|pc|d4|pc|s8|pg||
pc|dK|pc|d5|pc|d6|pc|c2|pg||
pc|dQ|pc|dT|pc|d9|pc|s5|pg||
pc|dJ|pc|c3|pc|c7|pc|h9|pg||
pc|d7|pc|c4|pc|cT|pc|h4|pg||
pc|d3|pc|c9|pc|h2|pc|c5|pg||
pc|d2|pc|cJ|pc|h6|pc|h8|pg||
pc|s9|pc|s4|pc|s6|pc|hT|pg||
pc|s7|pc|sJ|pc|sK|pc|c8|pg||
pc|sT|mc|12|pg||
qx|o19|st||md|1SAK865HAT42D4CKT2,SQJ7HQ7DAKQ8532C9,ST9432HJ3D97CQ753,SHK9865DJT6CAJ864|sv|e|mb|1S|mb|2D|mb|4S|mb|5D|mb|p|mb|p|mb|p|pg||
pc|s2|pc|d6|pc|s5|pc|s7|pg||
pc|cA|pc|c2|pc|c9|pc|c5|pg||
pc|c4|pc|cT|pc|d8|pc|c3|pg||
pc|sJ|pc|s3|pc|dT|pc|s6|pg||
pc|c6|pc|cK|pc|dQ|pc|c7|pg||
pc|sQ|pc|s4|pc|dJ|pc|s8|pg||
pc|h5|pc|h4|pc|hQ|pc|h3|pg||
pc|dA|pc|d7|pc|h6|pc|d4|pg||
pc|dK|pc|d9|mc|12|pg||
qx|c19|st||md|1SAK865HAT42D4CKT2,SQJ7HQ7DAKQ8532C9,ST9432HJ3D97CQ753,SHK9865DJT6CAJ864|sv|e|mb|1S|mb|2D|mb|4S|mb|5D|mb|d|mb|p|mb|p|mb|p|pg||
pc|sT|pc|d6|pc|s5|pc|s7|pg||
pc|cA|pc|c2|pc|c9|pc|c3|pg||
pc|c4|pc|cT|pc|d2|pc|c5|pg||
pc|sJ|pc|s2|pc|dT|pc|s6|pg||
pc|c6|pc|cK|pc|dQ|pc|c7|pg||
pc|sQ|pc|s3|pc|dJ|pc|s8|pg||
pc|h5|pc|h2|pc|hQ|pc|h3|pg||
pc|dA|pc|d7|pc|h6|pc|d4|pg||
pc|dK|pc|d9|mc|12|pg||
qx|o20|st||md|2SK82HT3D97CJ87632,SQT73HQJ87DAK82C9,SA4HA95DQT43CQT54,SJ965HK642DJ65CAK|sv|b|mb|1D|mb|p|mb|1H|mb|p|mb|2H|mb|p|mb|3N|mb|p|mb|4H|mb|p|mb|p|mb|p|pg||
pc|c6|pc|c9|pc|cQ|pc|cA|pg||
pc|h2|pc|h3|pc|hQ|pc|h9|pg||
pc|h7|pc|hA|pc|h4|pc|hT|pg||
pc|sA|pc|s5|pc|s8|pc|s3|pg||
pc|s4|pc|s6|pc|sK|pc|s7|pg||
pc|s2|pc|sT|pc|h5|pc|s9|pg||
pc|c4|pc|cK|pc|c2|pc|d2|pg||
mc|8|pg||
qx|c20|st||md|2SK82HT3D97CJ87632,SQT73HQJ87DAK82C9,SA4HA95DQT43CQT54,SJ965HK642DJ65CAK|sv|b|mb|1D|mb|p|mb|1H|mb|p|mb|2H|mb|p|mb|4H|mb|p|mb|p|mb|p|pg||
pc|c7|pc|c9|pc|cQ|pc|cA|pg||
pc|h2|pc|h3|pc|hQ|pc|hA|pg||
pc|sA|pc|s6|pc|s2|pc|s3|pg||
pc|s4|pc|s5|pc|sK|pc|s7|pg||
pc|s8|pc|sT|pc|h5|pc|s9|pg||
pc|h9|pc|h4|pc|hT|pc|hJ|pg||
pc|dA|pc|d3|pc|d5|mc|8|pg||
qx|o21|st||md|3ST7543HQ63D73CT85,S98HJ4DAK42CKQJ63,SKJ6HA975DQJ95C94,SAQ2HKT82DT86CA72|sv|n|mb|p|mb|1C|mb|p|mb|2C|mb|p|mb|2N|mb|p|mb|3N|mb|p|mb|p|mb|p|pg||
pc|s4|pc|s8|pc|sK|pc|sA|pg||
pc|cA|pc|c5|pc|c3|pc|c4|pg||
pc|c7|pc|c8|pc|cK|pc|c9|pg||
pc|cQ|pc|h7|pc|c2|pc|cT|pg||
pc|cJ|pc|h5|pc|s2|pc|s7|pg||
pc|c6|pc|h9|pc|d6|pc|s3|pg||
pc|hJ|pc|hA|pc|h2|pc|h3|pg||
pc|sJ|pc|sQ|pc|s5|pc|s9|pg||
pc|d8|pc|d3|pc|dA|pc|d5|pg||
pc|dK|pc|d9|pc|dT|pc|d7|pg||
pc|h4|pc|s6|pc|hK|pc|h6|pg||
mc|10|pg||
qx|c21|st||md|3ST7543HQ63D73CT85,S98HJ4DAK42CKQJ63,SKJ6HA975DQJ95C94,SAQ2HKT82DT86CA72|sv|n|mb|1D|mb|d|mb|p|mb|3N|mb|p|mb|p|mb|p|pg||
pc|dJ|pc|d6|pc|d7|pc|dA|pg||
pc|h4|pc|h5|pc|hT|pc|hQ|pg||
pc|d3|pc|d2|pc|dQ|pc|d8|pg||
pc|s6|pc|sQ|pc|s7|pc|s8|pg||
pc|dT|pc|s3|pc|d4|pc|d5|pg||
pc|cA|pc|c5|pc|c3|pc|c4|pg||
pc|c2|pc|c8|pc|cK|pc|c9|pg||
pc|cQ|pc|d9|pc|c7|pc|cT|pg||
pc|dK|pc|sJ|pc|h2|pc|s5|pg||
pc|cJ|pc|h7|pc|h8|pc|h3|pg||
pc|c6|pc|h9|pc|hK|pc|h6|pg||
pc|s9|pc|sK|pc|sA|pc|s4|pg||
pc|s2|pc|sT|pc|hJ|pc|hA|pg||
pg||
qx|o22|st||md|4SQTH9852D32CJ7543,S52H7DAKT974CAQ92,SKJ74HKQT43D865CK,SA9863HAJ6DQJCT86|sv|e|mb|1S|mb|p|mb|2D|mb|p|mb|2S|mb|p|mb|3C|mb|p|mb|3N|mb|p|mb|p|mb|p|pg||
pc|h8|pc|h7|pc|hK|pc|hA|pg||
pc|dQ|pc|d2|pc|d4|pc|d5|pg||
pc|dJ|pc|d3|pc|dA|pc|d6|pg||
pc|dK|pc|d8|pc|s3|pc|h2|pg||
pc|dT|pc|s4|pc|s6|pc|c3|pg||
pc|d9|pc|h4|pc|c8|pc|h5|pg||
pc|d7|pc|h3|pc|s8|pc|h9|pg||
pc|s2|pc|s7|pc|sA|pc|sT|pg||
pc|cT|pc|c4|pc|cA|pc|cK|pg||
pc|s5|pc|sK|pc|s9|pc|sQ|pg||
pc|sJ|pc|c6|pc|c5|pc|c2|pg||
pc|hT|pc|hJ|pc|c7|pc|c9|pg||
pc|h6|pc|cJ|pc|cQ|pc|hQ|pg||
pg||
qx|c22|st||md|4SQTH9852D32CJ7543,S52H7DAKT974CAQ92,SKJ74HKQT43D865CK,SA9863HAJ6DQJCT86|sv|e|mb|1S|mb|p|mb|2D|mb|p|mb|2S!|mb|p|mb|3C|mb|p|mb|3N|mb|p|mb|p|mb|p|pg||
pc|h5|pc|h7|pc|hQ|pc|h6|pg||
pc|h4|pc|hJ|pc|h2|pc|c2|pg||
pc|dQ|pc|d2|pc|d4|pc|d6|pg||
pc|c6|pc|c7|pc|cQ|pc|cK|pg||
pc|hK|pc|hA|pc|h9|pc|s2|pg||
pc|dJ|pc|d3|pc|dA|pc|d5|pg||
pc|dK|pc|d8|pc|s3|pc|c5|pg||
pc|dT|pc|s7|pc|s6|pc|c3|pg||
pc|d9|pc|s4|pc|s8|pc|h8|pg||
pc|d7|pc|h3|pc|cT|pc|sT|pg||
pc|s5|pc|sJ|pc|sA|pc|sQ|pg||
pc|c8|pc|c4|pc|cA|pc|hT|pg||
pc|c9|pc|sK|pc|s9|pc|cJ|pg||
pg||
qx|o23|st||md|1SK762H74DQT9CAT53,S95H9DK76CKJ98762,SAT43HQJ853DA43CQ,SQJ8HAKT62DJ852C4|sv|b|mb|p|mb|3C|mb|d|mb|p|mb|3S|mb|p|mb|p|mb|p|pg||
pc|h9|pc|hJ|pc|hK|pc|h4|pg||
pc|h2|pc|h7|pc|s5|pc|h3|pg||
pc|cK|pc|cQ|pc|c4|pc|cA|pg||
pc|sK|pc|s9|pc|s3|pc|s8|pg||
pc|s2|pc|c6|pc|sA|pc|sJ|pg||
pc|h5|pc|h6|pc|s6|pc|c2|pg||
pc|c5|pc|c7|pc|s4|pc|d2|pg||
pc|h8|pc|hT|pc|s7|pc|c8|pg||
pc|c3|pc|c9|pc|sT|pc|sQ|pg||
pc|hA|pc|cT|pc|cJ|pc|hQ|pg||
pc|d5|pc|dT|pc|d6|pc|d3|pg||
pc|d9|pc|d7|pc|dA|pc|d8|pg||
pc|d4|pc|dJ|pc|dQ|pc|dK|pg||
pg||
qx|c23|st||md|1SK762H74DQT9CAT53,S95H9DK76CKJ98762,SAT43HQJ853DA43CQ,SQJ8HAKT62DJ852C4|sv|b|mb|p|mb|3C|mb|d|mb|p|mb|3S|mb|p|mb|p|mb|p|pg||
pc|h9|pc|hQ|pc|hK|pc|h4|pg||
pc|c4|pc|cA|pc|c2|pc|cQ|pg||
pc|sK|pc|s5|pc|s3|pc|s8|pg||
pc|s2|pc|s9|pc|sA|pc|sJ|pg||
pc|h3|pc|hT|pc|h7|pc|c6|pg||
pc|d5|pc|dT|pc|dK|pc|dA|pg||
pc|hJ|pc|hA|pc|s7|pc|c7|pg||
pc|c3|pc|c8|pc|s4|pc|d2|pg||
pc|h8|pc|h2|pc|c5|pc|c9|pg||
pc|d3|pc|d8|pc|d9|pc|d6|pg||
pc|dQ|pc|d7|pc|d4|pc|dJ|pg||
pc|cT|pc|cJ|pc|sT|pc|sQ|pg||
pc|h6|pc|s6|pc|cK|pc|h5|pg||
pg||
qx|o24|st||md|2SAJ432HT75DQ54CA9,SQ6HAJ32DKJ863CK2,S987HQ9864DAT2C53,SKT5HKD97CQJT8764|sv|o|mb|1D|mb|p|mb|3C!|mb|p|mb|3N|mb|p|mb|p|mb|p|pg||
pc|h6|pc|hK|pc|h5|pc|h3|pg||
pc|c4|pc|c9|pc|cK|pc|c5|pg||
pc|c2|pc|c3|pc|c8|pc|cA|pg||
pc|hT|pc|hA|pc|h4|pc|s5|pg||
pc|s6|pc|s7|pc|sK|pc|sA|pg||
pc|h7|pc|h2|pc|h8|pc|c6|pg||
pc|hQ|pc|d7|pc|s4|pc|hJ|pg||
pc|h9|pc|d9|pc|s2|pc|d3|pg||
pc|s8|pc|sT|pc|sJ|pc|sQ|pg||
pc|dJ|pc|d2|pc|c7|pc|dQ|pg||
pc|d4|pc|d6|pc|dT|pc|cT|pg||
pc|dA|pc|cJ|pc|d5|pc|d8|pg||
pc|s9|pc|cQ|pc|s3|pc|dK|pg||
pg||
qx|c24|st||md|2SAJ432HT75DQ54CA9,SQ6HAJ32DKJ863CK2,S987HQ9864DAT2C53,SKT5HKD97CQJT8764|sv|o|mb|1D|mb|1H|mb|3C|mb|d|mb|p|mb|3H|mb|p|mb|p|mb|p|pg||
pc|d9|pc|d4|pc|dJ|pc|dA|pg||
pc|c5|pc|cQ|pc|cA|pc|c2|pg||
pc|h5|pc|h2|pc|h4|pc|hK|pg||
pc|d7|pc|d5|pc|dK|pc|d2|pg||
pc|cK|pc|c3|pc|c8|pc|c9|pg||
pc|d3|pc|dT|pc|cT|pc|dQ|pg||
pc|hT|pc|hA|pc|h6|pc|cJ|pg||
pc|hJ|pc|hQ|pc|c4|pc|h7|pg||
pc|h9|pc|c6|pc|s2|pc|h3|pg||
pc|s7|pc|s5|pc|s3|pc|sQ|pg||
pc|d8|pc|h8|pc|c7|pc|s4|pg||
pc|s8|pc|sT|pc|sJ|pc|s6|pg||
pc|sA|pc|d6|pc|s9|pc|sK|pg||
pg||
qx|o25|st||md|3S83HQ976DKQ9CKQJ8,SK97HK83DT762C962,SA6542HJ4DA53CAT3,SQJTHAT52DJ84C754|sv|e|mb|1S|mb|p|mb|2C|mb|p|mb|2S|mb|p|mb|3N|mb|p|mb|p|mb|p|pg||
pc|d2|pc|d3|pc|dJ|pc|dK|pg||
pc|h7|pc|h3|pc|hJ|pc|hA|pg||
pc|sQ|pc|s3|pc|s7|pc|s2|pg||
pc|d8|pc|d9|pc|dT|pc|dA|pg||
pc|h4|pc|h2|pc|h9|pc|hK|pg||
pc|sK|pc|sA|pc|sT|pc|s8|pg||
pc|cA|pc|c4|pc|c8|pc|c2|pg||
pc|c3|pc|c5|pc|cK|pc|c6|pg||
pc|cQ|pc|c9|pc|cT|pc|c7|pg||
pc|cJ|pc|h8|pc|s4|pc|d4|pg||
pc|dQ|pc|d6|pc|d5|pc|h5|pg||
pc|hQ|pc|d7|pc|s5|pc|hT|pg||
pc|h6|pc|s9|pc|s6|pc|sJ|pg||
pg||
qx|c25|st||md|3S83HQ976DKQ9CKQJ8,SK97HK83DT762C962,SA6542HJ4DA53CAT3,SQJTHAT52DJ84C754|sv|e|mb|1S|mb|p|mb|2C|mb|p|mb|2N|mb|p|mb|3N|mb|p|mb|p|mb|p|pg||
pc|h2|pc|h6|pc|h8|pc|hJ|pg||
mc|9|pg||
qx|o26|st||md|4SQ42HQ984DA86CAK7,ST65HJT76DKT9C962,SK97HK32DJ72CJ854,SAJ83HA5DQ543CQT3|sv|b|mb|1D|mb|d|mb|p|mb|1N|mb|p|mb|p|mb|p|pg||
pc|d3|pc|d6|pc|dK|pc|d7|pg||
pc|dT|pc|d2|pc|d4|pc|d8|pg||
pc|d9|pc|dJ|pc|d5|pc|dA|pg||
pc|h4|pc|h7|pc|hK|pc|hA|pg||
pc|dQ|pc|s2|pc|c2|pc|c4|pg||
pc|s3|pc|sQ|pc|s5|pc|s7|pg||
pc|hQ|pc|h6|pc|h3|pc|h5|pg||
pc|cA|pc|c6|pc|c5|pc|cT|pg||
pc|cK|pc|c9|pc|c8|pc|cQ|pg||
pc|c7|pc|hT|pc|cJ|pc|c3|pg||
pc|h2|pc|s8|pc|h8|pc|hJ|pg||
pc|s6|pc|sK|pc|sA|pc|s4|pg||
pc|sJ|pc|h9|pc|sT|pc|s9|pg||
pg||
qx|c26|st||md|4SQ42HQ984DA86CAK7,ST65HJT76DKT9C962,SK97HK32DJ72CJ854,SAJ83HA5DQ543CQT3|sv|b|mb|1D|mb|1N|mb|p|mb|2S!|mb|p|mb|2N|mb|p|mb|p|mb|p|pg||
pc|h6|pc|h2|pc|hA|pc|h4|pg||
pc|h5|pc|h9|pc|hT|pc|hK|pg||
pc|c4|pc|c3|pc|cA|pc|c2|pg||
pc|cK|pc|c6|pc|c5|pc|cT|pg||
pc|c7|pc|c9|pc|cJ|pc|cQ|pg||
pc|d3|pc|d6|pc|dK|pc|d2|pg||
pc|dT|pc|d7|pc|d5|pc|dA|pg||
pc|sQ|pc|s5|pc|s7|pc|s3|pg||
pc|hQ|pc|h7|pc|h3|pc|s8|pg||
pc|d8|pc|d9|pc|dJ|pc|dQ|pg||
pc|d4|pc|h8|pc|hJ|pc|c8|pg||
pc|sA|pc|s2|pc|s6|pc|s9|pg||
pc|sJ|pc|s4|pc|sT|pc|sK|pg||
pg||
qx|o27|st||md|1SKJ432HKJ8DAJ82C4,S986H9652D54CAQJ7,SA75HAQT43D93C852,SQTH7DKQT76CKT963|sv|o|mb|1S|mb|p|mb|2H|mb|p|mb|3H|mb|p|mb|4S|mb|p|mb|p|mb|p|pg||
pc|d5|pc|d3|pc|dQ|pc|dA|pg||
pc|s3|pc|s6|pc|sA|pc|sT|pg||
pc|s5|pc|sQ|pc|sK|pc|s8|pg||
pc|sJ|pc|s9|pc|s7|pc|d7|pg||
pc|hK|pc|h2|pc|h3|pc|h7|pg||
pc|hJ|pc|h5|pc|h4|pc|c3|pg||
pc|h8|pc|h6|pc|hA|pc|c6|pg||
pc|hQ|pc|d6|pc|c4|pc|h9|pg||
pc|hT|pc|c9|pc|d2|pc|c7|pg||
pc|d9|pc|dK|pc|d8|pc|d4|pg||
mc|12|pg||
qx|c27|st||md|1SKJ432HKJ8DAJ82C4,S986H9652D54CAQJ7,SA75HAQT43D93C852,SQTH7DKQT76CKT963|sv|o|mb|1S|mb|p|mb|1N!|mb|p|mb|2D|mb|p|mb|3S|mb|p|mb|4S|mb|p|mb|p|mb|p|pg||
pc|h5|pc|h3|pc|h7|pc|hK|pg||
pc|s3|pc|s6|pc|sA|pc|sT|pg||
pc|s5|pc|sQ|pc|sK|pc|s8|pg||
pc|sJ|pc|s9|pc|s7|pc|c3|pg||
pc|hJ|pc|h2|pc|h4|pc|c6|pg||
pc|h8|pc|h6|pc|hA|pc|c9|pg||
pc|hQ|pc|d6|pc|c4|pc|h9|pg||
pc|hT|pc|d7|pc|d2|pc|d5|pg||
mc|11|pg||
qx|o28|st||md|2ST52HAQ42DJ52CT65,SJ83HKJT53DKTCKQ4,SKHDAQ9764CAJ8732,SAQ9764H9876D83C9|sv|n|mb|1H|mb|2N!|mb|4H|mb|p|mb|p|mb|d|mb|p|mb|p|mb|p|pg||
pc|cA|pc|c9|pc|c5|pc|c4|pg||
pc|dA|pc|d3|pc|d2|pc|dT|pg||
pc|d4|pc|d8|pc|dJ|pc|dK|pg||
pc|cK|pc|c2|pc|h6|pc|c6|pg||
pc|h7|pc|h2|pc|h3|pc|d7|pg||
pc|h8|pc|hA|pc|h5|pc|d6|pg||
pc|cT|pc|cQ|pc|c7|pc|s4|pg||
pc|s8|pc|sK|pc|sA|pc|s2|pg||
pc|h9|pc|h4|pc|hT|pc|c3|pg||
pc|hK|pc|c8|pc|s6|pc|hQ|pg||
mc|10|pg||
qx|c28|st||md|2ST52HAQ42DJ52CT65,SJ83HKJT53DKTCKQ4,SKHDAQ9764CAJ8732,SAQ9764H9876D83C9|sv|n|mb|1H|mb|2N|mb|4C|mb|p|mb|4H|mb|p|mb|p|mb|p|pg||
pc|dA|pc|d3|pc|dJ|pc|dT|pg||
pc|d9|pc|d8|pc|d5|pc|dK|pg||
pc|cK|pc|cA|pc|c9|pc|c6|pg||
pc|sK|pc|sA|pc|s5|pc|s8|pg||
pc|h6|pc|h2|pc|h3|pc|d4|pg||
pc|h7|pc|h4|pc|h5|pc|d6|pg||
pc|h9|pc|hA|pc|hT|pc|c7|pg||
pc|hQ|pc|hK|pc|c2|pc|h8|pg||
pc|sJ|pc|c3|pc|s4|pc|s2|pg||
mc|10|pg||
qx|o29|st||md|3SK53HT7DA7532CKQ9,SQJ76H652DQ6CAJ42,SA94HAJ98DJ8CT876,ST82HKQ43DKT94C53|sv|b|mb|p|mb|p|mb|1D|mb|p|mb|1H|mb|p|mb|1N|mb|p|mb|p|mb|p|pg||
pc|s6|pc|s4|pc|s8|pc|s3|pg||
pc|sT|pc|sK|pc|s7|pc|s9|pg||
pc|hT|pc|h6|pc|h8|pc|hQ|pg||
pc|s2|pc|s5|pc|sJ|pc|sA|pg||
pc|c6|pc|c5|pc|cK|pc|cA|pg||
pc|sQ|pc|d8|pc|h3|pc|d2|pg||
pc|dQ|pc|dJ|pc|d9|pc|d3|pg||
pc|h2|pc|hJ|pc|hK|pc|h7|pg||
pc|c3|pc|cQ|pc|c2|pc|c7|pg||
pc|c9|pc|cJ|pc|c8|pc|h4|pg||
pc|d6|pc|h9|pc|dT|pc|d5|pg||
pc|d4|pc|d7|pc|c4|pc|cT|pg||
pc|dA|pc|h5|pc|hA|pc|dK|pg||
pg||
qx|c29|st||md|3SK53HT7DA7532CKQ9,SQJ76H652DQ6CAJ42,SA94HAJ98DJ8CT876,ST82HKQ43DKT94C53|sv|b|mb|p|mb|p|mb|1D|mb|p|mb|1H|mb|p|mb|1N|mb|p|mb|p|mb|p|pg||
pc|s6|pc|s4|pc|sT|pc|s3|pg||
pc|s8|pc|sK|pc|s7|pc|s9|pg||
pc|hT|pc|h2|pc|h8|pc|hK|pg||
pc|s2|pc|s5|pc|sJ|pc|sA|pg||
pc|c6|pc|c5|pc|cK|pc|cA|pg||
pc|sQ|pc|d8|pc|h4|pc|d3|pg||
pc|h6|pc|hJ|pc|hQ|pc|h7|pg||
pc|dK|pc|d2|pc|d6|pc|dJ|pg||
pc|dT|pc|dA|pc|dQ|pc|h9|pg||
pc|cQ|pc|c2|pc|c7|pc|c3|pg||
pc|c9|pc|cJ|pc|c8|pc|h3|pg||
pc|c4|pc|cT|pc|d4|pc|d5|pg||
pc|hA|pc|d9|pc|d7|pc|h5|pg||
pg||
qx|o30|st||md|4SAK3HKDAJ53CAQJ32,SQ85HA8763DKQ8C87,ST62HQT52DT4CKT95,SJ974HJ94D9762C64|sv|o|mb|p|mb|1C|mb|1H|mb|p|mb|p|mb|d|mb|p|mb|2C|mb|p|mb|2H!|mb|p|mb|3N|mb|p|mb|p|mb|p|pg||
pc|h4|pc|hK|pc|h3|pc|h5|pg||
pc|c2|pc|c8|pc|cT|pc|c4|pg||
pc|cK|pc|c6|pc|c3|pc|c7|pg||
pc|c9|pc|s7|pc|cJ|pc|h6|pg||
pc|cA|pc|h7|pc|c5|pc|hJ|pg||
pc|cQ|pc|h8|pc|h2|pc|h9|pg||
pc|d3|pc|dQ|pc|d4|pc|d2|pg||
pc|s5|pc|s6|pc|s9|pc|sA|pg||
pc|d5|pc|dK|pc|dT|pc|d6|pg||
pc|hA|pc|hT|pc|d7|pc|s3|pg||
mc|10|pg||
qx|c30|st||md|4SAK3HKDAJ53CAQJ32,SQ85HA8763DKQ8C87,ST62HQT52DT4CKT95,SJ974HJ94D9762C64|sv|o|mb|p|mb|1C|mb|1H|mb|1N|mb|p|mb|3N|mb|p|mb|p|mb|p|pg||
pc|h4|pc|hK|pc|hA|pc|h2|pg||
pc|h8|pc|hT|pc|hJ|pc|s3|pg||
pc|h9|pc|d3|pc|h3|pc|hQ|pg||
mc|9|pg||
qx|o31|st||md|1S3HAJT8DAQ74CAJ93,SJ972HQ97632D98CQ,SAKQT64HDT65CK754,S85HK54DKJ32CT862|sv|n|mb|1D|mb|2H|mb|2S|mb|p|mb|3N|mb|p|mb|4S|mb|p|mb|p|mb|p|pg||
pc|h4|pc|h8|pc|h9|pc|s4|pg||
pc|sA|pc|s5|pc|s3|pc|s2|pg||
pc|sK|pc|s8|pc|d4|pc|s7|pg||
pc|sQ|pc|d2|pc|d7|pc|s9|pg||
pc|cK|pc|c2|pc|c3|pc|cQ|pg||
pc|c4|pc|c6|pc|c9|pc|h2|pg||
pc|cA|pc|d8|pc|c5|pc|c8|pg||
pc|cJ|pc|h3|pc|c7|pc|cT|pg||
pc|hT|pc|h6|pc|s6|pc|h5|pg||
pc|d5|pc|d3|pc|dQ|pc|d9|pg||
pc|dA|pc|h7|pc|d6|pc|dJ|pg||
pc|hA|pc|hQ|pc|dT|pc|hK|pg||
pc|hJ|pc|sJ|pc|sT|pc|dK|pg||
pg||
qx|c31|st||md|1S3HAJT8DAQ74CAJ93,SJ972HQ97632D98CQ,SAKQT64HDT65CK754,S85HK54DKJ32CT862|sv|n|mb|1C|mb|p|mb|1S|mb|p|mb|1N|mb|p|mb|2S|mb|p|mb|3N|mb|p|mb|4S|mb|p|mb|p|mb|p|pg||
pc|c6|pc|c9|pc|cQ|pc|cK|pg||
pc|sA|pc|s5|pc|s3|pc|s2|pg||
pc|sK|pc|s8|pc|hT|pc|s7|pg||
pc|sQ|pc|h4|pc|d4|pc|s9|pg||
pc|d5|pc|d2|pc|dQ|pc|d8|pg||
pc|hA|pc|h3|pc|d6|pc|h5|pg||
mc|11|pg||
qx|o32|st||md|2SKJT7643H8DKTCAT2,S82HA63D8752C8543,SAHKJT95DJ643C976,SQ95HQ742DAQ9CKQJ|sv|e|mb|p|mb|p|mb|1N|mb|2D!|mb|p|mb|2H!|mb|p|mb|3S|mb|p|mb|4S|mb|p|mb|p|mb|p|pg||
pc|d5|pc|d3|pc|dA|pc|dT|pg||
pc|s5|pc|s3|pc|s8|pc|sA|pg||
pc|d4|pc|d9|pc|dK|pc|d2|pg||
pc|sK|pc|s2|pc|c6|pc|s9|pg||
pc|h8|pc|h3|pc|h5|pc|hQ|pg||
pc|cK|pc|c2|pc|c3|pc|c7|pg||
pc|cQ|pc|cA|pc|c4|pc|c9|pg||
pc|s4|pc|d7|pc|d6|pc|sQ|pg||
pc|cJ|pc|cT|pc|c5|pc|h9|pg||
mc|8|pg||
qx|c32|st||md|2SKJT7643H8DKTCAT2,S82HA63D8752C8543,SAHKJT95DJ643C976,SQ95HQ742DAQ9CKQJ|sv|e|mb|p|mb|p|mb|1N|mb|d|mb|p|mb|2C|mb|p|mb|3S|mb|p|mb|4S|mb|p|mb|p|mb|p|pg||
pc|d5|pc|d3|pc|dA|pc|dT|pg||
pc|cK|pc|c2|pc|c5|pc|c6|pg||
pc|cQ|pc|cA|pc|c3|pc|c7|pg||
pc|h8|pc|h3|pc|hJ|pc|hQ|pg||
pc|cJ|pc|cT|pc|c4|pc|c9|pg||
pc|d9|pc|dK|pc|d7|pc|d4|pg||
pc|s3|pc|s2|pc|sA|pc|s5|pg||
pc|hK|pc|h2|pc|s4|pc|h6|pg||
pc|sK|pc|s8|pc|h5|pc|s9|pg||
mc|8|pg||