vg|BBO5-2015WBTC-VC,QF4,I,17,32,ITALY,111,NETHERLANDS,121|
rs|1NE=,1NE=,3NS-1,3NS=,4HS+1,4HN=,4SE-1,4SE-2,3NS-3,3SW=,3NE=,2SS+1,3NW+1,3NW-2,4HW-1,3NW-2,3NE+1,3NE+1,6NN-2,3NN+1,2SN=,2HN-1,4HW-1,4HW-1,4SW=,6SW=,3NE=,2HNx-2,4SE+2,4SE=,2DW=,2SE-1|
pn|FERLAZZO,SIMONS,MANARA,PASMAN,MICHIELSEN,PAOLUZI,WORTEL,SACCAVINI|pg||
qx|o17|st||md|3S73HA874DA96CT873,SKT54HQJ6DQ32CA96,SQ962HT52DKJ7CKJ4,SAJ8HK93DT854CQ52|sv|o|mb|p|mb|p|mb|p|mb|1C|mb|p|mb|1N|mb|p|mb|p|mb|p|pg||
pc|h4|pc|hJ|pc|h2|pc|h3|pg||
pc|s4|pc|s2|pc|sJ|pc|s7|pg||
pc|sA|pc|s3|pc|s5|pc|s6|pg||
pc|s8|pc|d9|pc|sK|pc|s9|pg||
pc|c6|pc|c4|pc|cQ|pc|c7|pg||
pc|h9|pc|hA|pc|h6|pc|h5|pg||
pc|dA|pc|d2|pc|d7|pc|d5|pg||
pc|d6|pc|dQ|pc|dK|pc|d4|pg||
pc|sQ|pc|c2|pc|h8|pc|sT|pg||
pc|cK|pc|c5|pc|c3|pc|cA|pg||
pc|hQ|pc|hT|pc|hK|pc|h7|pg||
pc|d8|pc|c8|pc|d3|pc|dJ|pg||
pc|cJ|pc|dT|pc|cT|pc|c9|pg||
pg||
qx|c17|st||md|3S73HA874DA96CT873,SKT54HQJ6DQ32CA96,SQ962HT52DKJ7CKJ4,SAJ8HK93DT854CQ52|sv|o|mb|p|mb|p|mb|p|mb|1C!|mb|p|mb|1D|mb|p|mb|1S|mb|p|mb|1N|mb|p|mb|p|mb|p|pg||
pc|h4|pc|hJ|pc|hT|pc|h3|pg||
pc|s4|pc|s2|pc|sJ|pc|s3|pg||
pc|sA|pc|s7|pc|s5|pc|s6|pg||
pc|s8|pc|c8|pc|sK|pc|s9|pg||
pc|c6|pc|cK|pc|c2|pc|c3|pg||
pc|h5|pc|hK|pc|h8|pc|h6|pg||
pc|cQ|pc|c7|pc|c9|pc|c4|pg||
pc|c5|pc|cT|pc|cA|pc|cJ|pg||
pc|hQ|pc|h2|pc|h9|pc|hA|pg||
mc|7|pg||
qx|o18|st||md|4SQJ5HJ7D52CKQJ943,SK874HQ954D874C75,ST63HAK83DAKQ96CA,SA92HT62DJT3CT862|sv|n|mb|p|mb|p|mb|p|mb|1C!|mb|p|mb|1H!|mb|p|mb|2D|mb|p|mb|3C|mb|p|mb|3H|mb|p|mb|3N|mb|p|mb|p|mb|p|pg||
pc|s4|pc|s3|pc|sA|pc|s5|pg||
pc|s9|pc|sQ|pc|s7|pc|s6|pg||
pc|d5|pc|d7|pc|dA|pc|dJ|pg||
pc|dK|pc|d3|pc|d2|pc|d4|pg||
mc|8|pg||
qx|c18|st||md|4SQJ5HJ7D52CKQJ943,SK874HQ954D874C75,ST63HAK83DAKQ96CA,SA92HT62DJT3CT862|sv|n|mb|p|mb|p|mb|p|mb|1D|mb|p|mb|2C|mb|p|mb|2H|mb|p|mb|2N|mb|p|mb|3N|mb|p|mb|p|mb|p|pg||
pc|s7|pc|s3|pc|sA|pc|s5|pg||
pc|s9|pc|sJ|pc|sK|pc|s6|pg||
pc|s4|pc|sT|pc|s2|pc|sQ|pg||
pc|c4|pc|c5|pc|cA|pc|c6|pg||
pc|dA|pc|d3|pc|d2|pc|d4|pg||
pc|dK|pc|dT|pc|d5|pc|d7|pg||
pc|dQ|pc|dJ|pc|c3|pc|d8|pg||
pc|d9|pc|h2|mc|9|pg||
qx|o19|st||md|1S32HJ983D7643CK97,SA64H4DKJT982C842,SKQ75HAKQ52DAQCQT,SJT98HT76D5CAJ653|sv|e|mb|p|mb|2C!|mb|d|mb|p|mb|2H|mb|p|mb|4H|mb|p|mb|p|mb|p|pg||
pc|c4|pc|cT|pc|cA|pc|c7|pg||
pc|c3|pc|c9|pc|c8|pc|cQ|pg||
pc|hA|pc|h6|pc|h3|pc|h4|pg||
pc|hK|pc|h7|pc|h8|pc|d2|pg||
pc|h2|pc|hT|pc|hJ|pc|d8|pg||
pc|s2|pc|s6|pc|sK|pc|s8|pg||
pc|s5|pc|s9|pc|s3|pc|s4|pg||
pc|c5|pc|cK|pc|c2|pc|s7|pg||
pc|d4|pc|d9|pc|dQ|pc|d5|pg||
pc|sQ|pc|sT|pc|h9|pc|sA|pg||
pc|d3|pc|dT|pc|dA|pc|c6|pg||
mc|11|pg||
qx|c19|st||md|1S32HJ983D7643CK97,SA64H4DKJT982C842,SKQ75HAKQ52DAQCQT,SJT98HT76D5CAJ653|sv|e|mb|p|mb|p|mb|1H|mb|p|mb|3H|mb|p|mb|4H|mb|p|mb|p|mb|p|pg||
pc|d5|pc|d3|pc|dK|pc|dA|pg||
pc|sQ|pc|s8|pc|s2|pc|sA|pg||
pc|d9|pc|dQ|pc|h6|pc|d4|pg||
pc|sJ|pc|s3|pc|s6|pc|sK|pg||
pc|hA|pc|h7|pc|h3|pc|h4|pg||
pc|hK|pc|hT|pc|h8|pc|c2|pg||
mc|10|pg||
qx|o20|st||md|2S6HKJ65DJ8532CA85,S975HA98DK76CT932,SJ2HT42DAQT4CKQJ6,SAKQT843HQ73D9C74|sv|b|mb|p|mb|1D!|mb|4S|mb|p|mb|p|mb|p|pg||
pc|h5|pc|h8|pc|hT|pc|hQ|pg||
pc|sA|pc|s6|pc|s5|pc|s2|pg||
pc|sK|pc|d2|pc|s7|pc|sJ|pg||
pc|d9|pc|d5|pc|dK|pc|dA|pg||
pc|cK|pc|c4|pc|c5|pc|c2|pg||
pc|cQ|pc|c7|pc|c8|pc|c3|pg||
pc|dQ|pc|s8|pc|d3|pc|d6|pg||
pc|s3|pc|h6|pc|s9|pc|d4|pg||
pc|c9|pc|c6|pc|s4|pc|cA|pg||
pc|sQ|pc|d8|pc|d7|pc|dT|pg||
pc|sT|pc|dJ|pc|cT|pc|cJ|pg||
pc|h3|pc|hJ|pc|hA|pc|h2|pg||
pc|h9|pc|h4|pc|h7|pc|hK|pg||
pg||
qx|c20|st||md|2S6HKJ65DJ8532CA85,S975HA98DK76CT932,SJ2HT42DAQT4CKQJ6,SAKQT843HQ73D9C74|sv|b|mb|p|mb|1C!|mb|1S|mb|d|mb|2S|mb|p|mb|4S|mb|p|mb|p|mb|p|pg||
pc|d2|pc|dK|pc|dA|pc|d9|pg||
pc|d4|pc|s3|pc|d5|pc|d6|pg||
pc|sA|pc|s6|pc|s5|pc|s2|pg||
pc|sK|pc|d3|pc|s7|pc|sJ|pg||
pc|c4|pc|c8|pc|c9|pc|cJ|pg||
pc|c6|pc|c7|pc|cA|pc|c2|pg||
pc|d8|pc|d7|pc|dT|pc|sT|pg||
pc|h3|pc|h5|pc|hA|pc|h2|pg||
pc|h8|pc|h4|mc|8|pg||
qx|o21|st||md|3SQ987HK32DQ93CT74,SAJT64H96DT85CQJ8,S2HA74DAKJ642CK95,SK53HQJT85D7CA632|sv|n|mb|1D!|mb|1H|mb|1S|mb|p|mb|3D|mb|p|mb|3N|mb|p|mb|p|mb|p|pg||
pc|s4|pc|s2|pc|sK|pc|s7|pg||
pc|s5|pc|s9|pc|sT|pc|h4|pg||
pc|h9|pc|hA|pc|hQ|pc|h2|pg||
pc|dA|pc|d7|pc|d3|pc|d5|pg||
pc|d2|pc|c3|pc|dQ|pc|d8|pg||
pc|d9|pc|dT|pc|dK|pc|c2|pg||
pc|dJ|pc|c6|pc|c4|pc|h6|pg||
pc|h7|pc|hT|pc|hK|pc|c8|pg||
pc|c7|pc|cQ|pc|cK|pc|cA|pg||
pc|hJ|pc|h3|pc|s6|pc|d4|pg||
pc|s3|pc|s8|pc|sJ|pc|d6|pg||
pc|sA|pc|c5|pc|h5|pc|sQ|pg||
pc|cJ|pc|c9|pc|h8|pc|cT|pg||
pg||
qx|c21|st||md|3SQ987HK32DQ93CT74,SAJT64H96DT85CQJ8,S2HA74DAKJ642CK95,SK53HQJT85D7CA632|sv|n|mb|1D|an|alerted|mb|1H|mb|d|mb|1S|mb|3D|mb|3S|mb|p|mb|p|mb|p|pg||
pc|dA|pc|d7|pc|d3|pc|d5|pg||
pc|s2|pc|s3|pc|s7|pc|sT|pg||
pc|h9|pc|h7|pc|h5|pc|hK|pg||
pc|c7|pc|cQ|pc|cK|pc|cA|pg||
pc|hQ|pc|h2|pc|h6|pc|hA|pg||
pc|c9|pc|c2|pc|c4|pc|cJ|pg||
pc|d8|pc|d6|pc|s5|pc|dQ|pg||
pc|hJ|pc|h3|pc|c8|pc|h4|pg||
pc|sK|pc|s8|pc|s4|pc|d2|pg||
pc|hT|pc|s9|pc|sJ|pc|d4|pg||
mc|9|pg||
qx|o22|st||md|4SAJ9654H762DAQ9CA,SQ72HK95DJ5CQT983,S8HJT83DT8764CJ64,SKT3HAQ4DK32CK752|sv|e|mb|1N|mb|2D!|an|1M|mb|3N|mb|p|mb|p|mb|p|pg||
pc|s4|pc|s2|pc|s8|pc|sT|pg||
pc|c5|pc|cA|pc|c3|pc|c4|pg||
pc|sA|pc|s7|pc|d4|pc|s3|pg||
pc|s6|pc|sQ|pc|d7|pc|sK|pg||
pc|cK|pc|d9|pc|c8|pc|c6|pg||
pc|c7|pc|s5|pc|cQ|pc|cJ|pg||
pc|cT|pc|d8|pc|c2|pc|h6|pg||
pc|c9|pc|d6|pc|d2|pc|dQ|pg||
pc|h5|pc|h8|pc|hA|pc|h2|pg||
pc|hQ|pc|h7|pc|h9|pc|h3|pg||
pc|h4|pc|s9|pc|hK|pc|hT|pg||
pc|d5|pc|dT|pc|dK|pc|dA|pg||
pc|sJ|pc|dJ|pc|hJ|pc|d3|pg||
pg||
qx|c22|st||md|4SAJ9654H762DAQ9CA,SQ72HK95DJ5CQT983,S8HJT83DT8764CJ64,SKT3HAQ4DK32CK752|sv|e|mb|1N|mb|d|mb|p|mb|2D|mb|p|mb|2S|mb|p|mb|p|mb|p|pg||
pc|c3|pc|c4|pc|cK|pc|cA|pg||
pc|s4|pc|s2|pc|s8|pc|sT|pg||
pc|c2|pc|h6|pc|cQ|pc|c6|pg||
pc|dJ|pc|d4|pc|d2|pc|dQ|pg||
pc|sA|pc|s7|pc|d6|pc|s3|pg||
pc|sJ|pc|sQ|pc|d7|pc|sK|pg||
pc|d3|pc|d9|pc|d5|pc|dT|pg||
pc|cJ|pc|c5|pc|h2|pc|c8|pg||
mc|9|pg||
qx|o23|st||md|1ST542HAQT96D42CQ6,SAKQ9HKJ4DT9CAKT2,SJ73H73DAK3C98543,S86H852DQJ8765CJ7|sv|b|mb|p|mb|2N|mb|p|mb|3C!|mb|p|mb|3D!|an|BOTH/ANY M 4|mb|p|mb|3N|mb|p|mb|p|mb|p|pg||
pc|dA|pc|d5|pc|d4|pc|d9|pg||
pc|c9|pc|cJ|pc|cQ|pc|cA|pg||
pc|dT|pc|d3|pc|dQ|pc|d2|pg||
pc|h2|pc|h9|pc|hJ|pc|h7|pg||
pc|sA|pc|s3|pc|s6|pc|s4|pg||
pc|sK|pc|s7|pc|s8|pc|s2|pg||
pc|cK|pc|c3|pc|c7|pc|c6|pg||
pc|cT|pc|c8|pc|d6|pc|h6|pg||
pc|sQ|pc|sJ|pc|h5|pc|s5|pg||
pc|s9|pc|c4|pc|d7|pc|sT|pg||
pc|hA|pc|h4|pc|h3|pc|h8|pg||
pc|hT|pc|hK|pc|c5|pc|d8|pg||
pc|c2|pc|dK|pc|dJ|pc|hQ|pg||
pg||
qx|c23|st||md|1ST542HAQT96D42CQ6,SAKQ9HKJ4DT9CAKT2,SJ73H73DAK3C98543,S86H852DQJ8765CJ7|sv|b|mb|p|mb|2N|mb|p|mb|3N|mb|p|mb|p|mb|p|pg||
pc|dA|pc|d5|pc|d2|pc|dT|pg||
pc|c8|pc|c7|pc|c6|pc|cT|pg||
pc|d9|pc|dK|pc|d6|pc|d4|pg||
pc|c5|pc|cJ|pc|cQ|pc|cA|pg||
pc|cK|pc|c4|pc|d7|pc|h6|pg||
pc|sA|pc|s7|pc|s6|pc|s2|pg||
pc|sK|pc|s3|pc|s8|pc|s4|pg||
pc|sQ|pc|sJ|pc|d8|pc|s5|pg||
pc|s9|pc|d3|pc|dJ|pc|sT|pg||
pc|h9|pc|hJ|pc|h3|pc|h2|pg||
pc|c2|pc|c3|pc|h5|pc|hT|pg||
pc|c9|pc|h8|pc|hQ|pc|h4|pg||
pc|h7|pc|dQ|pc|hA|pc|hK|pg||
pg||
qx|o24|st||md|2ST2H5DA832CAQJ987,S53HAKJ984DQ9CKT3,SKJ984HQT63D64C65,SAQ76H72DKJT75C42|sv|o|mb|1H|mb|1S|mb|2D!|mb|3C|mb|3H|mb|p|mb|4H|mb|p|mb|p|mb|p|pg||
pc|c6|pc|c2|pc|cA|pc|c3|pg||
pc|cQ|pc|cK|pc|c5|pc|c4|pg||
pc|dQ|pc|d6|pc|dK|pc|dA|pg||
pc|cJ|pc|cT|pc|hT|pc|s6|pg||
pc|d4|pc|d5|pc|d2|pc|d9|pg||
pc|hA|pc|h3|pc|h2|pc|h5|pg||
pc|hK|pc|h6|pc|h7|pc|d8|pg||
pc|hJ|pc|hQ|pc|s7|pc|s2|pg||
mc|9|pg||
qx|c24|st||md|2ST2H5DA832CAQJ987,S53HAKJ984DQ9CKT3,SKJ984HQT63D64C65,SAQ76H72DKJT75C42|sv|o|mb|1H|mb|p|mb|1S|mb|3C|mb|p|mb|p|mb|d|mb|p|mb|3N|mb|p|mb|p|mb|p|pg||
pc|c6|pc|c2|pc|cJ|pc|c3|pg||
pc|c7|pc|cK|pc|c5|pc|c4|pg||
pc|dQ|pc|d4|pc|d5|pc|dA|pg||
pc|cA|pc|cT|pc|s4|pc|s6|pg||
pc|cQ|mc|7|pg||
qx|o25|st||md|3S653HQT96DQ5CK865,SK74H83D9874CAQ94,SQT8HKJ742DJ32CJ7,SAJ92HA5DAKT6CT32|sv|e|mb|p|mb|1N|mb|p|mb|2C!|mb|p|mb|2S|mb|p|mb|2N|mb|p|mb|3N|mb|p|mb|p|mb|p|pg||
pc|h9|pc|h3|pc|hK|pc|h5|pg||
pc|h4|pc|hA|pc|h6|pc|h8|pg||
pc|s2|pc|s6|pc|sK|pc|s8|pg||
pc|s4|pc|sT|pc|sJ|pc|s5|pg||
pc|sA|pc|s3|pc|s7|pc|sQ|pg||
pc|s9|pc|c6|pc|d4|pc|d2|pg||
pc|dA|pc|d5|pc|d7|pc|d3|pg||
pc|dK|pc|dQ|pc|d8|pc|dJ|pg||
pc|dT|pc|hT|pc|d9|pc|h2|pg||
pc|d6|mc|10|pg||
qx|c25|st||md|3S653HQT96DQ5CK865,SK74H83D9874CAQ94,SQT8HKJ742DJ32CJ7,SAJ92HA5DAKT6CT32|sv|e|mb|p|mb|1N|mb|p|mb|3N|mb|p|mb|p|mb|p|pg||
pc|hT|pc|h3|pc|h2|pc|hA|pg||
pc|cT|pc|cK|pc|cA|pc|c7|pg||
pc|d4|pc|d2|pc|dK|pc|d5|pg||
pc|s2|pc|s5|pc|sK|pc|s8|pg||
pc|s4|pc|sT|pc|sJ|pc|s3|pg||
pc|sA|pc|s6|pc|s7|pc|sQ|pg||
pc|s9|pc|h6|pc|d7|pc|h4|pg||
pc|dA|pc|dQ|pc|d8|pc|d3|pg||
pc|c2|pc|c8|pc|cQ|pc|cJ|pg||
pc|c9|mc|10|pg||
qx|o26|st||md|4SQ97H754DK32CKJT2,SJT853H92D9874C93,SAK4HAQT8DA65CAQ6,S62HKJ63DQJTC8754|sv|b|mb|p|mb|p|mb|p|mb|1C!|mb|p|mb|1H!|mb|p|mb|2N!|mb|p|mb|3C|an|ALERT|mb|p|mb|3D!|mb|p|mb|6N|mb|p|mb|p|mb|p|pg||
pc|dQ|pc|dK|pc|d4|pc|d6|pg||
pc|h4|pc|h2|pc|hT|pc|hJ|pg||
pc|dT|pc|d2|pc|d9|pc|dA|pg||
pc|cQ|pc|c4|pc|cK|pc|c3|pg||
pc|h5|pc|h9|pc|hQ|pc|hK|pg||
pc|dJ|pc|d3|pc|d7|pc|d5|pg||
mc|10|pg||
qx|c26|st||md|4SQ97H754DK32CKJT2,SJT853H92D9874C93,SAK4HAQT8DA65CAQ6,S62HKJ63DQJTC8754|sv|b|mb|p|mb|p|mb|p|mb|2C!|mb|p|mb|2D|mb|p|mb|2N|mb|p|mb|3N|mb|p|mb|p|mb|p|pg||
pc|dQ|pc|d2|pc|d7|pc|d5|pg||
pc|dJ|pc|dK|pc|d4|pc|d6|pg||
pc|h4|pc|h2|pc|hT|pc|hJ|pg||
pc|dT|pc|d3|pc|d8|pc|dA|pg||
pc|cA|pc|c4|pc|c2|pc|c3|pg||
pc|c6|pc|c5|pc|cT|pc|c9|pg||
pc|cK|pc|s3|pc|cQ|pc|c7|pg||
pc|cJ|pc|d9|pc|h8|pc|c8|pg||
pc|s7|pc|s8|pc|sA|pc|s2|pg||
pc|s4|pc|s6|pc|sQ|pc|s5|pg||
pc|h5|pc|h9|pc|hQ|pc|hK|pg||
pc|h3|pc|h7|pc|sT|pc|hA|pg||
pc|sK|pc|h6|pc|s9|pc|sJ|pg||
pg||
qx|o27|st||md|1SA5HJ96DKJ76CK952,S43H875D9532CQJ64,SJ8762HKQT4DAT8CT,SKQT9HA32DQ4CA873|sv|o|mb|1D!|mb|p|mb|2S!|mb|p|mb|p|mb|p|pg||
pc|sK|pc|sA|pc|s3|pc|s2|pg||
pc|s5|pc|s4|pc|s6|pc|sT|pg||
pc|c3|pc|c2|pc|cJ|pc|cT|pg||
pc|h8|pc|hK|pc|hA|pc|h6|pg||
pc|cA|pc|c5|pc|c4|pc|s7|pg||
pc|s8|pc|s9|mc|8|pg||
qx|c27|st||md|1SA5HJ96DKJ76CK952,S43H875D9532CQJ64,SJ8762HKQT4DAT8CT,SKQT9HA32DQ4CA873|sv|o|mb|1C!|mb|p|mb|1H!|mb|p|mb|1S!|mb|p|mb|2H|mb|p|mb|p|mb|p|pg||
pc|h2|pc|h9|pc|h5|pc|h4|pg||
pc|sA|pc|s4|pc|s2|pc|s9|pg||
pc|s5|pc|s3|pc|s6|pc|sT|pg||
pc|hA|pc|h6|pc|h7|pc|hT|pg||
pc|h3|pc|hJ|pc|h8|pc|hQ|pg||
pc|s7|pc|sQ|pc|d6|pc|d2|pg||
pc|c3|pc|c2|pc|cQ|pc|cT|pg||
pc|c4|pc|d8|pc|cA|pc|c5|pg||
pc|sK|pc|c9|mc|7|pg||
qx|o28|st||md|2SJ85H4DT85CAKT832,ST7HAKQJ93DK764C4,SQ962HT75DAQJ2CQ7,SAK43H862D93CJ965|sv|n|mb|1H|mb|p|mb|1S|mb|2C|mb|2H|mb|d|mb|3H|mb|p|mb|4H|mb|p|mb|p|mb|p|pg||
pc|cQ|pc|c5|pc|c3|pc|c4|pg||
pc|c7|pc|c9|pc|cT|pc|h3|pg||
pc|s7|pc|s2|pc|sA|pc|s5|pg||
pc|d3|pc|d5|pc|dK|pc|dA|pg||
pc|s6|pc|sK|pc|s8|pc|sT|pg||
pc|d9|pc|dT|pc|d4|pc|d2|pg||
pc|cA|pc|hA|pc|sQ|pc|c6|pg||
pc|d6|pc|dQ|pc|h2|pc|d8|pg||
pc|s3|pc|sJ|pc|hK|pc|s9|pg||
pc|hQ|pc|h5|pc|h6|pc|h4|pg||
pc|d7|pc|dJ|pc|h8|pc|c2|pg||
pc|s4|pc|c8|pc|h9|pc|hT|pg||
pc|h7|pc|cJ|pc|cK|pc|hJ|pg||
pg||
qx|c28|st||md|2SJ85H4DT85CAKT832,ST7HAKQJ93DK764C4,SQ962HT75DAQJ2CQ7,SAK43H862D93CJ965|sv|n|mb|1H|mb|p|mb|2H|mb|3C|mb|4H|mb|p|mb|p|mb|p|pg||
pc|cQ|pc|c5|pc|c8|pc|c4|pg||
pc|c7|pc|c9|pc|cT|pc|h3|pg||
pc|s7|pc|s2|pc|sA|pc|s8|pg||
pc|d3|pc|d8|pc|dK|pc|dA|pg||
pc|h5|pc|h2|pc|h4|pc|h9|pg||
pc|d4|pc|dQ|pc|d9|pc|d5|pg||
pc|h7|pc|h6|pc|c2|pc|hJ|pg||
pc|d6|pc|d2|pc|h8|pc|dT|pg||
pc|c6|pc|cA|pc|hQ|pc|s6|pg||
pc|hA|pc|hT|pc|s3|pc|c3|pg||
pc|hK|pc|s9|pc|cJ|pc|cK|pg||
pc|sT|pc|sQ|pc|sK|pc|s5|pg||
pc|s4|pc|sJ|pc|d7|pc|dJ|pg||
pg||
qx|o29|st||md|3ST9HAQ4D86CT98642,SKJ862HJ987DQ2CK3,S73HT5D9743CAQJ75,SAQ54HK632DAKJT5C|sv|b|mb|p|mb|1D|mb|p|mb|1S|mb|p|mb|4C!|mb|p|mb|4S|mb|p|mb|p|mb|p|pg||
pc|hT|pc|h2|pc|hQ|pc|h8|pg||
pc|hA|pc|h7|pc|h5|pc|h3|pg||
pc|h4|pc|h9|pc|s3|pc|h6|pg||
pc|c5|pc|s4|pc|c6|pc|c3|pg||
pc|sA|pc|s9|pc|s2|pc|s7|pg||
pc|sQ|pc|sT|pc|s6|mc|10|pg||
qx|c29|st||md|3ST9HAQ4D86CT98642,SKJ862HJ987DQ2CK3,S73HT5D9743CAQJ75,SAQ54HK632DAKJT5C|sv|b|mb|p|mb|1D|mb|p|mb|2S!|mb|p|mb|2N!|mb|p|mb|3N|mb|p|mb|4C!|mb|p|mb|4H|mb|p|mb|4S|mb|p|mb|5H|mb|p|mb|6S|mb|p|mb|p|mb|p|pg||
pc|cA|pc|s4|pc|c6|pc|c3|pg||
pc|sA|pc|s9|pc|s2|pc|s3|pg||
pc|sQ|pc|sT|pc|s6|pc|s7|pg||
mc|12|pg||
qx|o30|st||md|4SQ843H93DJT64CJ94,SA97HQDKQ9872CAK8,SKJ2HAJ7642D5CQ62,ST65HKT85DA3CT753|sv|o|mb|p|mb|p|mb|1D|mb|1H|mb|1N|mb|p|mb|3N|mb|p|mb|p|mb|p|pg||
pc|h9|pc|hQ|pc|hA|pc|h5|pg||
pc|h7|pc|hK|pc|h3|pc|s7|pg||
pc|dA|pc|d4|pc|d2|pc|d5|pg||
pc|d3|pc|d6|pc|dK|pc|h4|pg||
pc|d7|pc|h2|pc|s6|pc|dT|pg||
pc|c4|pc|cA|pc|c2|pc|c3|pg||
pc|dQ|pc|h6|pc|s5|pc|dJ|pg||
pc|d8|pc|s2|pc|c5|pc|s3|pg||
pc|d9|pc|sK|pc|hT|pc|c9|pg||
pc|sA|pc|sJ|pc|sT|pc|s4|pg||
pc|cK|pc|c6|pc|c7|pc|cJ|pg||
pc|c8|pc|cQ|pc|cT|pc|s8|pg||
pc|hJ|pc|h8|pc|sQ|pc|s9|pg||
pg||
qx|c30|st||md|4SQ843H93DJT64CJ94,SA97HQDKQ9872CAK8,SKJ2HAJ7642D5CQ62,ST65HKT85DA3CT753|sv|o|mb|p|mb|p|mb|1D|mb|2H|mb|p|mb|p|mb|d|mb|p|mb|p|mb|p|pg||
pc|c7|pc|c4|pc|cK|pc|c2|pg||
pc|dK|pc|d5|pc|d3|pc|d4|pg||
pc|hQ|pc|hA|pc|h5|pc|h3|pg||
pc|cQ|pc|c5|pc|c9|pc|cA|pg||
pc|c8|pc|c6|pc|c3|pc|cJ|pg||
pc|d6|pc|d2|pc|h2|pc|dA|pg||
pc|sK|pc|s5|pc|s3|pc|sA|pg||
pc|d7|pc|h4|pc|h8|pc|dT|pg||
mc|6|pg||
qx|o31|st||md|1SQ5H92DQJ965CK962,SK2HKQJ74DAK84CT3,SJ76HT653D72CAQ74,SAT9843HA8DT3CJ85|sv|n|mb|p|mb|1H|mb|p|mb|1S|mb|p|mb|2D|mb|p|mb|2S|mb|p|mb|4S|mb|p|mb|p|mb|p|pg||
pc|h9|pc|h4|pc|h6|pc|hA|pg||
pc|s3|pc|s5|pc|sK|pc|s6|pg||
pc|s2|pc|s7|pc|sA|pc|sQ|pg||
pc|h8|pc|h2|pc|hK|pc|h3|pg||
pc|hQ|pc|h5|pc|c5|pc|d5|pg||
pc|hJ|pc|hT|pc|c8|pc|c9|pg||
pc|h7|mc|12|pg||
qx|c31|st||md|1SQ5H92DQJ965CK962,SK2HKQJ74DAK84CT3,SJ76HT653D72CAQ74,SAT9843HA8DT3CJ85|sv|n|mb|p|mb|1H|mb|p|mb|1S|mb|p|mb|2C!|mb|p|mb|2D!|mb|p|mb|3N|an|alerted|mb|p|mb|4S|mb|p|mb|p|mb|p|pg||
pc|c6|pc|c3|pc|cA|pc|c5|pg||
pc|c4|pc|c8|pc|cK|pc|cT|pg||
pc|h9|pc|h4|pc|h3|pc|hA|pg||
pc|s3|pc|s5|pc|sK|pc|s6|pg||
pc|s2|pc|s7|pc|sA|pc|sQ|pg||
pc|d3|pc|d5|pc|dA|pc|d2|pg||
mc|10|pg||
qx|o32|st||md|2SJ95HQJ752DKT8CA3,S7HKT3DAQJ532CQ85,SKQ32H964D964CK42,SAT864HA8D7CJT976|sv|e|mb|1D|mb|p|mb|1S|mb|p|mb|2D|mb|p|mb|p|mb|p|pg||
pc|h6|pc|hA|pc|h7|pc|h3|pg||
pc|h8|pc|hJ|pc|hK|pc|h4|pg||
pc|hT|pc|h9|pc|d7|pc|h2|pg||
pc|sA|pc|s5|pc|s7|pc|s3|pg||
pc|s4|pc|s9|pc|d2|pc|s2|pg||
pc|c8|pc|c2|pc|cJ|pc|cA|pg||
pc|h5|pc|d3|pc|d4|pc|c6|pg||
pc|cK|pc|c7|pc|c3|pc|c5|pg||
pc|c4|pc|c9|pc|d8|pc|cQ|pg||
pc|hQ|pc|dJ|pc|sK|pc|s6|pg||
pc|dA|pc|d6|pc|s8|pc|dT|pg||
pc|d5|pc|d9|pc|cT|pc|dK|pg||
pc|sJ|pc|dQ|pc|sQ|pc|sT|pg||
pg||
qx|c32|st||md|2SJ95HQJ752DKT8CA3,S7HKT3DAQJ532CQ85,SKQ32H964D964CK42,SAT864HA8D7CJT976|sv|e|mb|1D|mb|p|mb|1S|mb|p|mb|2D|mb|p|mb|2S|mb|p|mb|p|mb|p|pg||
pc|h2|pc|h3|pc|h9|pc|hA|pg||
pc|d7|pc|d8|pc|dA|pc|d4|pg||
pc|dQ|pc|d6|pc|s4|pc|dT|pg||
pc|c6|pc|cA|pc|c5|pc|c2|pg||
pc|h5|pc|hK|pc|h4|pc|h8|pg||
pc|hT|pc|h6|pc|s6|pc|hJ|pg||
pc|c9|pc|c3|pc|cQ|pc|cK|pg||
pc|s2|pc|s8|pc|s9|pc|s7|pg||
pc|h7|pc|d2|pc|c4|pc|sT|pg||
pc|sA|pc|s5|pc|d3|pc|s3|pg||
pc|cJ|pc|sJ|pc|c8|pc|d9|pg||
pc|dK|pc|d5|pc|sQ|pc|c7|pg||
pc|sK|pc|cT|pc|hQ|pc|dJ|pg||
pg||