vg|SLAVA CUP - 2008,R7,I,17,24,Team 1,0,Team 2,0|
rs|,4HN=,,3NN=,,4HN=,,3NN+1,,3NW+1,,1NN=,,3SW-1,,4SN=|
pn|Khokhlov,Kozlov,Matushko,Petrunin,Volker,Chernitsa,Bessis,Rybnikov|pg||
qx|c17|st||md|3SAJ863HQT82DQC872,SQ9754HK64DT64CT5,SK2HA975DJ72CAKJ4,STHJ3DAK9853CQ963|sv|o|mb|1N|mb|p|mb|2C|mb|p|mb|2H|mb|p|mb|4H|mb|p|mb|p|mb|p|pg||
pc|dA|pc|dQ|pc|dT|pc|d2|pg||
pc|sT|pc|sJ|pc|sQ|pc|sK|pg||
pc|s2|pc|c3|pc|sA|pc|s4|pg||
pc|c2|pc|c5|pc|cK|pc|c6|pg||
pc|dJ|pc|dK|pc|h2|pc|d4|pg||
pc|c7|pc|cT|pc|cA|pc|c9|pg||
pc|d7|pc|d8|pc|h8|pc|d6|pg||
pc|c8|pc|h4|pc|c4|pc|cQ|pg||
pc|s9|pc|h9|pc|hJ|pc|s3|pg||
pc|d9|pc|hT|pc|hK|pc|hA|pg||
pc|h5|pc|h3|pc|hQ|pc|h6|pg||
pc|s6|pc|s7|pc|h7|pc|d3|pg||
pc|cJ|pc|d5|pc|s8|pc|s5|pg||
pg||
qx|c18|st||md|4SQJT95HAJT5DK432C,SK8632HKQ3DQ6CJ85,S4H98DAJ95CAQT964,SA7H7642DT87CK732|sv|n|mb|p|mb|1S|mb|p|mb|2C|mb|p|mb|2H|mb|p|mb|3N|mb|p|mb|p|mb|p|pg||
pc|dT|pc|d2|pc|dQ|pc|dA|pg||
pc|s4|pc|s7|pc|sQ|pc|sK|pg||
pc|d6|pc|dJ|pc|d7|pc|d3|pg||
pc|d5|pc|d8|pc|dK|pc|c8|pg||
pc|sJ|pc|s2|pc|c4|pc|sA|pg||
pc|h7|pc|h5|pc|hQ|pc|h9|pg||
pc|c5|pc|cQ|pc|cK|pc|hT|pg||
pc|h2|pc|hA|pc|h3|pc|h8|pg||
pc|sT|pc|s3|pc|c6|pc|c2|pg||
pc|s9|pc|s6|pc|c9|pc|h4|pg||
pc|d4|pc|cJ|mc|9|pg||
qx|c19|st||md|1SAKT62H92D98CQ875,S987HDJ542CJT9632,S3HAKQ7653DKT3CK4,SQJ54HJT84DAQ76CA|sv|e|mb|p|mb|p|mb|2C!|mb|p|mb|2S|mb|p|mb|3H|mb|p|mb|4H|mb|p|mb|p|mb|p|pg||
pc|s4|pc|sA|pc|s7|pc|s3|pg||
pc|sK|pc|s8|pc|d3|pc|s5|pg||
pc|h2|pc|cJ|pc|hA|pc|h4|pg||
pc|hK|pc|h8|pc|h9|pc|c2|pg||
pc|hQ|pc|hT|pc|s2|pc|s9|pg||
pc|h7|pc|hJ|pc|c5|pc|c6|pg||
pc|cA|pc|c7|pc|c3|pc|cK|pg||
pc|sQ|pc|s6|pc|c9|pc|h3|pg||
pc|c4|pc|d6|pc|cQ|pc|cT|pg||
pc|c8|pc|d2|pc|dT|pc|d7|pg||
pc|d8|pc|d4|pc|dK|pc|dA|pg||
mc|10|pg||
qx|c20|st||md|2SAK62HA5DJT62CAQ2,SJT4HQ643DA874CJ4,S97HJT97DKQ3CKT75,SQ853HK82D95C9863|sv|b|mb|p|mb|p|mb|p|mb|1D|mb|p|mb|1H|mb|p|mb|1S|mb|p|mb|1N|mb|p|mb|3N|mb|p|mb|p|mb|p|pg||
pc|s3|pc|s2|pc|sT|pc|s7|pg||
pc|sJ|pc|s9|pc|s5|pc|sA|pg||
pc|d2|pc|dA|pc|dQ|pc|d5|pg||
pc|s4|pc|h7|pc|s8|pc|sK|pg||
pc|d6|pc|d4|pc|dK|pc|d9|pg||
pc|d3|pc|c6|pc|dT|pc|d7|pg||
pc|dJ|pc|d8|pc|h9|pc|c3|pg||
pc|cA|pc|c4|pc|c5|pc|c8|pg||
pc|cQ|pc|cJ|pc|c7|pc|c9|pg||
pc|c2|pc|h3|pc|cK|pc|h2|pg||
pc|cT|pc|h8|mc|10|pg||
qx|c21|st||md|3SJ97HJ98652DT765C,SK85HQ74DKQ43CT86,S63HK3DAJ2CQJ9742,SAQT42HATD98CAK53|sv|n|mb|1C|mb|d|mb|1H|mb|1N|mb|2C|mb|d|mb|2H|mb|p|mb|p|mb|2S|mb|p|mb|3C!|mb|p|mb|3N|mb|p|mb|p|mb|p|pg||
pc|hK|pc|hA|pc|h6|pc|h4|pg||
pc|sA|pc|s7|pc|s5|pc|s3|pg||
pc|s2|pc|s9|pc|sK|pc|s6|pg||
pc|s8|pc|c4|pc|sQ|pc|sJ|pg||
pc|sT|pc|h2|pc|d3|pc|c2|pg||
pc|s4|pc|h5|pc|c6|pc|h3|pg||
pc|d8|pc|d5|pc|dQ|pc|d2|pg||
pc|hQ|pc|dJ|pc|hT|pc|h8|pg||
mc|10|pg||
qx|c22|st||md|4SAQJ8H43DK962CK52,SK7HJ765DA754CT73,S654HAQ82DQT8CQ98,ST932HKT9DJ3CAJ64|sv|e|mb|p|mb|1D|mb|p|mb|1H|mb|p|mb|1S|mb|p|mb|1N|mb|p|mb|p|mb|p|pg||
pc|c4|pc|c2|pc|cT|pc|cQ|pg||
pc|s5|pc|s2|pc|sQ|pc|sK|pg||
pc|c7|pc|c8|pc|c6|pc|c5|pg||
pc|s6|pc|s3|pc|sJ|pc|s7|pg||
pc|d2|pc|d4|pc|dT|pc|dJ|pg||
pc|cA|pc|cK|pc|c3|pc|c9|pg||
pc|cJ|pc|h3|pc|d5|pc|h2|pg||
pc|sT|pc|sA|pc|h6|pc|s4|pg||
pc|d9|pc|d7|pc|d8|pc|d3|pg||
pc|s8|pc|h5|pc|dQ|pc|s9|pg||
pc|hT|mc|7|pg||
qx|c23|st||md|1S82HQ7643D8743CJ6,SAK9764HAJ8D2CA95,SJT3HK52DAKQ9CK83,SQ5HT9DJT65CQT742|sv|b|mb|p|mb|1C!|mb|d|mb|p|mb|1H|mb|1S|mb|p|mb|1N|mb|2H|mb|2S|mb|3H|mb|3S|mb|p|mb|p|mb|p|pg||
pc|dA|pc|d5|pc|d7|pc|d2|pg||
pc|s3|pc|sQ|pc|s2|pc|s4|pg||
pc|hT|pc|h3|pc|h8|pc|hK|pg||
pc|sT|pc|s5|pc|s8|pc|sA|pg||
pc|sK|pc|sJ|pc|d6|pc|h4|pg||
pc|cA|pc|c3|pc|c2|pc|c6|pg||
pc|c9|pc|c8|pc|c4|pc|cJ|pg||
pc|d3|pc|s6|pc|d9|pc|dT|pg||
pc|s9|pc|h2|pc|c7|pc|d8|pg||
pc|c5|pc|cK|pc|cT|pc|h6|pg||
pc|dK|pc|dJ|pc|d4|pc|s7|pg||
pc|hA|pc|h5|pc|h9|pc|h7|pg||
pc|hJ|pc|dQ|pc|cQ|pc|hQ|pg||
pg||
qx|c24|st||md|2SJT86H754DKT864C5,SQ973HAK98DA9CT82,SAK542H6DJ7CAKQ93,SHQJT32DQ532CJ764|sv|o|mb|1C!|mb|1S|mb|p|mb|3S|mb|p|mb|4S|mb|p|mb|p|mb|p|pg||
pc|hQ|pc|h4|pc|h8|pc|h6|pg||
pc|d2|pc|d4|pc|dA|pc|dJ|pg||
pc|hK|pc|s2|pc|h2|pc|h5|pg||
pc|sA|pc|h3|pc|s6|pc|s3|pg||
pc|cA|pc|c4|pc|c5|pc|c2|pg||
pc|cK|pc|c6|pc|h7|pc|c8|pg||
pc|cQ|pc|c7|pc|d6|pc|cT|pg||
pc|d7|pc|d3|pc|dT|pc|d9|pg||
pc|dK|pc|s7|pc|c3|pc|d5|pg||
pc|hA|pc|c9|pc|hT|pc|s8|pg||
mc|10|pg||