vg|41st WBTC-BBO5,DOSB-SF3,I,1,16,GERMANY,67,FRANCE,75|
rs|3DN-1,2NS-2,4SN-2,4HE=,4HS+1,4HN-2,2DEx-1,2HWx-1,2DN-1,3NS-1,3NN+1,3NS+1,4SN=,4SN=,1NE=,1NE-1,5HE-6,5DSx-2,2SN+2,4SN=,4SW=,3NE+1,7SS=,7SS=,2SW=,2SW=,2CWx-3,1NS+2,3NN+1,6DS=,3NW-1,3NW-1|
pn|WLADOW,LEVY,ELINESCU,LEENHARDT,LASSERRE,STRATER,POIZAT,KRATZ|pg||
qx|o1|st||md|3S7654HATDJT95CAQ7,SKT832HKDQ4CKJ852,SAJHQJ853DA872C43,SQ9H97642DK63CT96|sv|o|mb|1H|mb|p|mb|1S|mb|p|mb|2D|mb|p|mb|p|mb|2S|mb|p|mb|p|mb|3D|mb|p|mb|p|mb|p|pg||
pc|sQ|pc|s4|pc|s2|pc|sA|pg||
pc|h5|pc|h4|pc|hT|pc|hK|pg||
pc|sK|pc|sJ|pc|s9|pc|s6|pg||
pc|s8|pc|d8|pc|c6|pc|s5|pg||
pc|h8|pc|h2|pc|hA|pc|d4|pg||
pc|sT|pc|d7|pc|dK|pc|s7|pg||
pc|h7|pc|dJ|pc|dQ|pc|h3|pg||
pc|s3|pc|c3|pc|c9|pc|d5|pg||
pc|dT|pc|c2|pc|d2|pc|d6|pg||
pc|cA|pc|c5|pc|c4|pc|cT|pg||
pc|c7|pc|c8|pc|dA|pc|h6|pg||
pc|hJ|pc|h9|pc|cQ|pc|cJ|pg||
pc|hQ|pc|d3|pc|d9|pc|cK|pg||
pg||
qx|c1|st||md|3S7654HATDJT95CAQ7,SKT832HKDQ4CKJ852,SAJHQJ853DA872C43,SQ9H97642DK63CT96|sv|o|mb|1H|mb|p|mb|1S|mb|p|mb|2D|mb|p|mb|2N|mb|p|mb|p|mb|p|pg||
pc|s3|pc|sJ|pc|sQ|pc|s4|pg||
pc|s9|pc|s5|pc|s2|pc|sA|pg||
pc|h3|pc|h4|pc|hT|pc|hK|pg||
pc|s8|pc|c3|pc|cT|pc|s6|pg||
pc|sT|pc|d2|pc|d6|pc|s7|pg||
pc|sK|pc|c4|pc|c6|pc|c7|pg||
pc|dQ|pc|dA|pc|d3|pc|dJ|pg||
pc|h5|pc|h2|pc|hA|pc|c5|pg||
pc|d5|pc|d4|pc|d7|pc|dK|pg||
pc|c9|pc|cQ|pc|cK|pc|h8|pg||
mc|6|pg||
qx|o2|st||md|4SKT86H2DA952CQ873,S542HAKT863DCJ965,SA973HQ5DKQT87CT4,SQJHJ974DJ643CAK2|sv|n|mb|1D|mb|p|mb|1H|mb|2D|mb|2H|mb|d|mb|4H|mb|4S|mb|p|mb|p|mb|p|pg||
pc|cA|pc|c3|pc|c6|pc|cT|pg||
pc|d3|pc|d2|pc|s5|pc|d7|pg||
pc|c5|pc|c4|pc|cK|pc|c7|pg||
pc|d6|pc|d5|pc|s2|pc|d8|pg||
pc|hA|pc|h5|pc|h4|pc|h2|pg||
pc|c9|pc|s9|pc|c2|pc|c8|pg||
pc|s3|pc|sJ|pc|sK|pc|s4|pg||
pc|s6|pc|h3|pc|sA|pc|sQ|pg||
mc|8|pg||
qx|c2|st||md|4SKT86H2DA952CQ873,S542HAKT863DCJ965,SA973HQ5DKQT87CT4,SQJHJ974DJ643CAK2|sv|n|mb|1H|mb|p|mb|4H|mb|p|mb|p|mb|p|pg||
pc|c7|pc|c9|pc|cT|pc|cA|pg||
pc|h4|pc|h2|pc|hA|pc|h5|pg||
pc|hK|pc|hQ|pc|h7|pc|s8|pg||
pc|cJ|pc|c4|pc|c2|pc|cQ|pg||
mc|10|pg||
qx|o3|st||md|1SA7H872DAQ4CQJT98,ST986532H654D7C72,SQ4HAKJ93D98652C4,SKJHQTDKJT3CAK653|sv|e|mb|1N!|mb|p|mb|4D!|mb|d|mb|4H|mb|p|mb|p|mb|p|pg||
pc|d7|pc|d8|pc|dT|pc|dQ|pg||
pc|h2|pc|h6|pc|hK|pc|hT|pg||
pc|hA|pc|hQ|pc|h7|pc|h4|pg||
pc|hJ|pc|c5|pc|h8|pc|h5|pg||
pc|d6|pc|d3|pc|d4|pc|s2|pg||
pc|c4|pc|cK|pc|c8|pc|c2|pg||
pc|dK|pc|dA|pc|s3|pc|d2|pg||
pc|cQ|pc|c7|pc|h3|pc|c3|pg||
pc|d5|pc|dJ|pc|c9|pc|s5|pg||
pc|sJ|mc|11|pg||
qx|c3|st||md|1SA7H872DAQ4CQJT98,ST986532H654D7C72,SQ4HAKJ93D98652C4,SKJHQTDKJT3CAK653|sv|e|mb|1C|mb|p|mb|1H|mb|p|mb|1N|mb|p|mb|2D!|mb|p|mb|4H|mb|p|mb|p|mb|p|pg||
pc|cA|pc|c8|pc|c2|pc|c4|pg||
pc|dJ|pc|dQ|pc|d7|pc|d2|pg||
pc|h2|pc|h4|pc|hA|pc|hT|pg||
pc|s4|pc|sJ|pc|sA|pc|s3|pg||
pc|h7|pc|h5|pc|h3|pc|hQ|pg||
pc|dK|pc|dA|pc|h6|pc|d5|pg||
pc|c7|pc|sQ|pc|cK|pc|c9|pg||
pc|dT|pc|d4|pc|s2|pc|d6|pg||
mc|8|pg||
qx|o4|st||md|2SKQJ7HTDK852CAQJ8,ST9865HAKJ85DT9C3,S432HQ9762DQCT975,SAH43DAJ7643CK642|sv|b|mb|p|mb|p|mb|1D|mb|p|mb|1S|mb|p|mb|2C|mb|d|mb|2D|mb|p|mb|p|mb|d|mb|p|mb|p|mb|p|pg||
pc|sK|pc|s5|pc|s4|pc|sA|pg||
pc|c4|pc|c8|pc|c3|pc|cT|pg||
pc|dQ|pc|dA|pc|d2|pc|d9|pg||
pc|c2|pc|cJ|pc|dT|pc|c5|pg||
pc|s6|pc|s2|pc|d3|pc|s7|pg||
pc|c6|pc|cQ|pc|h5|pc|c7|pg||
pc|hT|pc|hA|pc|h6|pc|h3|pg||
pc|s8|pc|s3|pc|d6|pc|sJ|pg||
pc|h4|pc|d5|pc|h8|pc|h2|pg||
pc|cA|pc|s9|pc|c9|pc|cK|pg||
pc|sQ|pc|sT|pc|h7|pc|d4|pg||
pc|d7|pc|d8|pc|hJ|pc|hQ|pg||
pc|dK|pc|hK|pc|h9|pc|dJ|pg||
pg||
qx|c4|st||md|2SKQJ7HTDK852CAQJ8,ST9865HAKJ85DT9C3,S432HQ9762DQCT975,SAH43DAJ7643CK642|sv|b|mb|2H|mb|p|mb|p|mb|d|mb|p|mb|p|mb|p|pg||
pc|dQ|pc|dA|pc|d8|pc|dT|pg||
pc|sA|pc|s7|pc|s5|pc|s2|pg||
pc|d3|pc|d2|pc|d9|pc|h2|pg||
pc|cT|pc|c2|pc|cJ|pc|c3|pg||
pc|hT|pc|hA|pc|h6|pc|h3|pg||
pc|s6|pc|s3|pc|h4|pc|sJ|pg||
pc|c4|pc|c8|pc|h5|pc|c5|pg||
pc|s8|pc|s4|pc|d4|pc|sQ|pg||
pc|dK|pc|s9|pc|c7|pc|d6|pg||
pc|sK|pc|sT|pc|c9|pc|d7|pg||
pc|d5|pc|h8|pc|h9|pc|dJ|pg||
mc|7|pg||
qx|o5|st||md|3SKJT7HK975DA32C93,S8643HAQ3D8CAQT52,SA92HT2DKT754CKJ7,SQ5HJ864DQJ96C864|sv|n|mb|1D|mb|p|mb|1H|mb|d|mb|p|mb|2C|mb|2D|mb|p|mb|p|mb|p|pg||
pc|c4|pc|c3|pc|cA|pc|c7|pg||
pc|c5|pc|cK|pc|c6|pc|c9|pg||
pc|cJ|pc|c8|pc|d2|pc|cT|pg||
pc|sJ|pc|s4|pc|s2|pc|sQ|pg||
pc|s5|pc|s7|pc|s8|pc|sA|pg||
pc|d4|pc|d6|pc|dA|pc|d8|pg||
pc|d3|pc|s3|pc|dK|pc|d9|pg||
pc|s9|pc|dQ|pc|sT|pc|s6|pg||
pc|dJ|pc|h5|pc|c2|pc|d5|pg||
pc|hJ|pc|hK|pc|hA|pc|h2|pg||
pc|hQ|pc|hT|pc|h4|pc|h7|pg||
pc|cQ|pc|d7|pc|h6|pc|h9|pg||
pc|dT|pc|h8|pc|sK|pc|h3|pg||
pg||
qx|c5|st||md|3SKJT7HK975DA32C93,S8643HAQ3D8CAQT52,SA92HT2DKT754CKJ7,SQ5HJ864DQJ96C864|sv|n|mb|p|mb|p|mb|1D|mb|d|mb|r|mb|1H|mb|p|mb|p|mb|2H|mb|p|mb|2N|mb|p|mb|3N|mb|p|mb|p|mb|p|pg||
pc|c5|pc|cJ|pc|c6|pc|c3|pg||
pc|d4|pc|d9|pc|d2|pc|d8|pg||
pc|c8|pc|c9|pc|cA|pc|c7|pg||
pc|c2|pc|cK|pc|c4|pc|h5|pg||
pc|dT|pc|dJ|pc|dA|pc|h3|pg||
pc|sJ|pc|s3|pc|sA|pc|s5|pg||
pc|dK|pc|d6|pc|d3|pc|hQ|pg||
pc|h2|pc|h4|pc|h7|pc|hA|pg||
pc|cQ|pc|d5|pc|h6|pc|h9|pg||
pc|cT|pc|d7|pc|dQ|pc|s7|pg||
pc|s4|pc|s2|pc|sQ|pc|sK|pg||
mc|8|pg||
qx|o6|st||md|4SK4HAKJ3DAJ843CT5,S9732HQTD952CAQ73,SAQ6H865DQT6CK964,SJT85H9742DK7CJ82|sv|e|mb|p|mb|1C|mb|p|mb|1N|mb|p|mb|2C|mb|p|mb|2D|mb|p|mb|3N|mb|p|mb|p|mb|p|pg||
pc|sJ|pc|sK|pc|s2|pc|s6|pg||
pc|d3|pc|d2|pc|dT|pc|dK|pg||
pc|s5|pc|s4|pc|s9|pc|sQ|pg||
pc|h5|pc|h4|pc|hJ|pc|hQ|pg||
pc|cA|pc|c4|pc|c2|pc|c5|pg||
mc|10|pg||
qx|c6|st||md|4SK4HAKJ3DAJ843CT5,S9732HQTD952CAQ73,SAQ6H865DQT6CK964,SJT85H9742DK7CJ82|sv|e|mb|p|mb|1N|mb|p|mb|3N|mb|p|mb|p|mb|p|pg||
pc|s2|pc|s6|pc|sT|pc|sK|pg||
pc|d3|pc|d2|pc|dT|pc|dK|pg||
pc|s5|pc|s4|pc|s3|pc|sQ|pg||
pc|h5|pc|h2|pc|hJ|pc|hQ|pg||
pc|s7|pc|sA|pc|s8|pc|c5|pg||
pc|dQ|pc|d7|pc|d4|pc|d5|pg||
pc|d6|pc|sJ|pc|dA|pc|d9|pg||
pc|dJ|pc|c3|pc|c4|pc|c8|pg||
pc|d8|pc|c7|pc|c6|pc|h4|pg||
pc|hA|pc|hT|pc|h6|pc|h9|pg||
pc|hK|pc|cQ|pc|h8|pc|h7|pg||
pc|h3|pc|s9|pc|c9|pc|c2|pg||
pc|cT|pc|cA|pc|cK|pc|cJ|pg||
pg||
qx|o7|st||md|1SA7652HQJ5DJ952C8,S9HA763DAQ3C96543,SQJT83H92DKT76CAK,SK4HKT84D84CQJT72|sv|b|mb|p|mb|p|mb|1S|mb|p|mb|4S|mb|p|mb|p|mb|p|pg||
pc|cQ|pc|c8|pc|c4|pc|cA|pg||
pc|cK|pc|c7|pc|d2|pc|c5|pg||
pc|sQ|pc|sK|pc|sA|pc|s9|pg||
pc|s2|pc|h7|pc|sJ|pc|s4|pg||
pc|h2|pc|h8|pc|hJ|pc|hA|pg||
pc|dA|pc|d6|pc|d8|pc|d5|pg||
pc|h6|pc|h9|pc|hK|pc|h5|pg||
pc|h4|pc|hQ|pc|h3|pc|d7|pg||
pc|s5|pc|c3|pc|sT|pc|c2|pg||
pc|s3|pc|cT|pc|s6|pc|c6|pg||
pc|d9|pc|d3|pc|dT|pc|d4|pg||
pc|dK|pc|cJ|pc|dJ|pc|dQ|pg||
pc|s8|pc|hT|pc|s7|pc|c9|pg||
pg||
qx|c7|st||md|1SA7652HQJ5DJ952C8,S9HA763DAQ3C96543,SQJT83H92DKT76CAK,SK4HKT84D84CQJT72|sv|b|mb|p|mb|p|mb|1S|mb|p|mb|4S|mb|p|mb|p|mb|p|pg||
pc|cQ|pc|c8|pc|c6|pc|cA|pg||
pc|sQ|pc|sK|pc|sA|pc|s9|pg||
pc|s2|pc|h3|pc|sJ|pc|s4|pg||
pc|cK|pc|c7|pc|d2|pc|c3|pg||
pc|h9|pc|hK|pc|h5|pc|h6|pg||
pc|d8|pc|d9|pc|dA|pc|d6|pg||
pc|hA|pc|h2|pc|h4|pc|hQ|pg||
pc|h7|pc|d7|pc|h8|pc|hJ|pg||
pc|d5|pc|d3|pc|dT|pc|d4|pg||
mc|10|pg||
qx|o8|st||md|2SQJ92HJ6DAT3CAKJ3,SA863HKQ8DQJ2CT62,ST74HAT7532D96C74,SK5H94DK8754CQ985|sv|o|mb|1C|mb|p|mb|1N|mb|p|mb|p|mb|p|pg||
pc|sQ|pc|sA|pc|s4|pc|s5|pg||
pc|dQ|pc|d6|pc|d4|pc|d3|pg||
pc|dJ|pc|d9|pc|d5|pc|dT|pg||
pc|d2|pc|h7|pc|d7|pc|dA|pg||
pc|hJ|pc|hK|pc|h2|pc|h4|pg||
pc|s3|pc|s7|pc|sK|pc|s2|pg||
pc|dK|pc|c3|pc|s6|pc|h3|pg||
pc|d8|pc|cJ|pc|s8|pc|c4|pg||
mc|7|pg||
qx|c8|st||md|2SQJ92HJ6DAT3CAKJ3,SA863HKQ8DQJ2CT62,ST74HAT7532D96C74,SK5H94DK8754CQ985|sv|o|mb|1S|mb|p|mb|1N|mb|p|mb|p|mb|p|pg||
pc|cA|pc|c2|pc|c4|pc|c5|pg||
pc|s2|pc|sA|pc|s4|pc|s5|pg||
pc|dQ|pc|d6|pc|d5|pc|dA|pg||
pc|sQ|pc|s3|pc|s7|pc|sK|pg||
pc|d4|pc|d3|pc|dJ|pc|d9|pg||
pc|d2|pc|h5|pc|dK|pc|dT|pg||
pc|d8|pc|h6|pc|s6|pc|h2|pg||
pc|d7|pc|c3|pc|s8|pc|h3|pg||
pc|h4|pc|hJ|pc|hK|pc|hA|pg||
pc|c7|pc|c8|pc|cJ|pc|c6|pg||
pc|sJ|pc|cT|pc|sT|pc|h9|pg||
pc|cK|pc|h8|pc|h7|pc|c9|pg||
pc|s9|pc|hQ|pc|hT|pc|cQ|pg||
pg||
qx|o9|st||md|3SJTH7DAKQ87CQ9743,SAQ643HAT2D95CAK2,S85HKJ943DJ6432CJ,SK972HQ865DTCT865|sv|e|mb|p|mb|p|mb|2N|mb|d|mb|5D|mb|p|mb|p|mb|d|mb|p|mb|5H|mb|p|mb|p|mb|p|pg||
pc|dA|pc|d5|pc|d4|pc|dT|pg||
pc|dK|pc|d9|pc|d2|pc|c5|pg||
pc|c3|pc|cA|pc|cJ|pc|c6|pg||
pc|h2|pc|h4|pc|hQ|pc|h7|pg||
pc|h5|pc|c4|pc|hA|pc|h3|pg||
pc|sA|pc|s8|pc|s2|pc|sT|pg||
pc|s3|pc|s5|pc|sK|pc|sJ|pg||
pc|s9|pc|c7|pc|sQ|pc|h9|pg||
pc|hK|pc|h6|pc|c9|pc|hT|pg||
pc|hJ|pc|h8|pc|cQ|pc|c2|pg||
pc|d3|pc|c8|pc|d7|pc|s4|pg||
mc|5|pg||
qx|c9|st||md|3SJTH7DAKQ87CQ9743,SAQ643HAT2D95CAK2,S85HKJ943DJ6432CJ,SK972HQ865DTCT865|sv|e|mb|p|mb|p|mb|1D|mb|1S|mb|d|mb|2S|mb|3C|mb|4S|mb|5D|mb|p|mb|p|mb|d|mb|p|mb|p|mb|p|pg||
pc|d5|pc|d2|pc|dT|pc|dA|pg||
pc|h7|pc|hA|pc|h3|pc|h8|pg||
pc|sA|pc|s5|pc|s2|pc|sT|pg||
pc|cA|pc|cJ|pc|c5|pc|c7|pg||
pc|s4|pc|s8|pc|sK|pc|sJ|pg||
mc|9|pg||
qx|o10|st||md|4SQT4H98765D542CA2,SJ7HQ32DAJ87CT974,SAK8632HAJDK6C863,S95HKT4DQT93CKQJ5|sv|b|mb|p|mb|p|mb|p|mb|1S|mb|p|mb|1N|mb|p|mb|2S|mb|p|mb|p|mb|p|pg||
pc|cK|pc|cA|pc|c7|pc|c6|pg||
pc|c2|pc|c9|pc|c3|pc|c5|pg||
pc|d8|pc|dK|pc|d3|pc|d2|pg||
pc|s3|pc|s9|pc|sQ|pc|s7|pg||
pc|s4|pc|sJ|pc|sA|pc|s5|pg||
pc|c8|pc|cJ|pc|sT|pc|c4|pg||
mc|10|pg||
qx|c10|st||md|4SQT4H98765D542CA2,SJ7HQ32DAJ87CT974,SAK8632HAJDK6C863,S95HKT4DQT93CKQJ5|sv|b|mb|p|mb|p|mb|p|mb|1S|mb|p|mb|2S|mb|p|mb|4S|mb|p|mb|p|mb|p|pg||
pc|cK|pc|c2|pc|c4|pc|c3|pg||
pc|c5|pc|cA|pc|c7|pc|c6|pg||
pc|h5|pc|h3|pc|hJ|pc|hK|pg||
pc|cQ|pc|s4|pc|c9|pc|c8|pg||
pc|d2|pc|d7|pc|dK|pc|d3|pg||
pc|s3|pc|s5|pc|sQ|pc|s7|pg||
pc|sT|pc|sJ|pc|sA|pc|s9|pg||
pc|sK|pc|d9|pc|d4|pc|cT|pg||
pc|s8|pc|cJ|pc|h6|pc|d8|pg||
pc|s6|pc|dT|pc|d5|pc|dJ|pg||
pc|s2|pc|dQ|pc|h7|pc|h2|pg||
pc|hA|pc|h4|pc|h8|pc|hQ|pg||
pc|d6|pc|hT|pc|h9|pc|dA|pg||
pg||
qx|o11|st||md|1SAJTH83DJT42CT983,SKQ974H94DK76CKJ2,S65HKJT75DA83CQ64,S832HAQ62DQ95CA75|sv|o|mb|p|mb|1S|mb|2H|mb|d!|mb|p|mb|2S|mb|p|mb|4S|mb|p|mb|p|mb|p|pg||
pc|s5|pc|s2|pc|sT|pc|sK|pg||
pc|c2|pc|c4|pc|cA|pc|c8|pg||
pc|s3|pc|sA|pc|s4|pc|s6|pg||
pc|cT|pc|cJ|pc|cQ|pc|c7|pg||
pc|c6|pc|c5|pc|c9|pc|cK|pg||
pc|sQ|pc|h5|pc|s8|pc|sJ|pg||
pc|s9|pc|h7|pc|h2|pc|h3|pg||
pc|s7|pc|hJ|pc|d5|pc|d2|pg||
pc|h4|pc|hK|pc|hA|pc|h8|pg||
pc|hQ|pc|c3|pc|h9|pc|hT|pg||
pc|h6|pc|d4|pc|d6|pc|d3|pg||
pc|d9|pc|dT|pc|dK|pc|dA|pg||
pc|d8|pc|dQ|pc|dJ|pc|d7|pg||
pg||
qx|c11|st||md|1SAJTH83DJT42CT983,SKQ974H94DK76CKJ2,S65HKJT75DA83CQ64,S832HAQ62DQ95CA75|sv|o|mb|p|mb|1S|mb|p|mb|2C|mb|p|mb|3C|mb|p|mb|3N|mb|p|mb|p|mb|p|pg||
pc|d2|pc|d6|pc|dA|pc|d5|pg||
pc|hJ|pc|h2|pc|h3|pc|h4|pg||
pc|hT|pc|hQ|pc|h8|pc|h9|pg||
pc|s2|pc|sJ|pc|sK|pc|s5|pg||
pc|c2|pc|c6|pc|cA|pc|c3|pg||
pc|s3|pc|sA|pc|s4|pc|s6|pg||
pc|dJ|mc|10|pg||
qx|o12|st||md|2S976542HK4DA9CKQJ,SJHQ8632DJ832CT95,SAKQTHADKQ754CA83,S83HJT975DT6C7642|sv|n|mb|p|mb|2C!|mb|p|mb|2N!|mb|p|mb|3D|mb|p|mb|3S|mb|p|mb|7S|mb|p|mb|p|mb|p|pg||
pc|c9|mc|13|pg||
qx|c12|st||md|2S976542HK4DA9CKQJ,SJHQ8632DJ832CT95,SAKQTHADKQ754CA83,S83HJT975DT6C7642|sv|n|mb|p|mb|1D|mb|p|mb|1S|mb|p|mb|3C|mb|p|mb|3D|mb|p|mb|3S|mb|p|mb|4N!|mb|p|mb|7S|mb|p|mb|p|mb|p|pg||
pc|cT|pc|c3|pc|c2|pc|cK|pg||
mc|13|pg||
qx|o13|st||md|3ST8HQJDA874CQ9864,SQ732HKT7DKQ2CAKT,SA94HA96542DT95C5,SKJ65H83DJ63CJ732|sv|b|mb|p|mb|p|mb|p|mb|1N|mb|2D!|mb|p|mb|2H|mb|p|mb|p|mb|d|mb|p|mb|2S|mb|p|mb|p|mb|p|pg||
pc|c5|pc|c2|pc|c9|pc|cT|pg||
pc|s2|pc|sA|pc|s5|pc|s8|pg||
pc|dT|pc|d3|pc|dA|pc|dQ|pg||
pc|hQ|pc|hK|pc|hA|pc|h3|pg||
pc|h2|pc|h8|pc|hJ|pc|h7|pg||
pc|c4|pc|cA|pc|s4|pc|c3|pg||
pc|h5|pc|sJ|pc|d4|pc|hT|pg||
mc|8|pg||
qx|c13|st||md|3ST8HQJDA874CQ9864,SQ732HKT7DKQ2CAKT,SA94HA96542DT95C5,SKJ65H83DJ63CJ732|sv|b|mb|p|mb|p|mb|p|mb|1N|mb|2D!|mb|p|mb|2H|mb|p|mb|p|mb|d|mb|p|mb|2S|mb|p|mb|p|mb|p|pg||
pc|c5|pc|c2|pc|c4|pc|cT|pg||
pc|s2|pc|sA|pc|s5|pc|s8|pg||
pc|d5|pc|d3|pc|dA|pc|dQ|pg||
pc|c6|pc|cK|pc|s4|pc|c3|pg||
pc|dT|pc|d6|pc|d7|pc|dK|pg||
pc|s3|pc|s9|pc|sJ|pc|sT|pg||
pc|dJ|pc|d4|pc|d2|pc|d9|pg||
pc|h8|pc|hQ|pc|hK|pc|hA|pg||
pc|h2|pc|h3|pc|hJ|pc|h7|pg||
pc|c8|pc|cA|pc|h4|pc|c7|pg||
pc|hT|pc|h5|pc|s6|pc|d8|pg||
pc|cJ|pc|c9|pc|s7|pc|h6|pg||
pc|sQ|pc|h9|pc|sK|pc|cQ|pg||
pg||
qx|o14|st||md|4SQ9HAQ84DA73CAQT3,SAK853HJT3DJ8C765,SJ7642H965DT52CKJ,STHK72DKQ964C9842|sv|o|mb|p|mb|1C!|mb|1S|mb|p|mb|p|mb|d|mb|p|mb|p|mb|r|mb|p|mb|2C|mb|p|mb|p|mb|d|mb|p|mb|p|mb|p|pg||
pc|d5|pc|d4|pc|d7|pc|d8|pg||
pc|c6|pc|cJ|pc|c2|pc|c3|pg||
pc|cK|pc|c4|pc|cA|pc|c5|pg||
pc|cQ|pc|c7|pc|d2|pc|c8|pg||
pc|cT|pc|s5|pc|dT|pc|c9|pg||
pc|dA|pc|dJ|pc|h5|pc|d6|pg||
pc|sQ|pc|sA|pc|s2|pc|sT|pg||
pc|sK|pc|s4|pc|d9|pc|s9|pg||
pc|hJ|pc|h6|pc|h2|pc|h4|pg||
pc|h3|pc|h9|pc|hK|pc|hA|pg||
pc|hQ|pc|hT|pc|s6|pc|h7|pg||
pc|h8|pc|s3|pc|s7|pc|dK|pg||
pc|d3|pc|s8|pc|sJ|pc|dQ|pg||
pg||
qx|c14|st||md|4SQ9HAQ84DA73CAQT3,SAK853HJT3DJ8C765,SJ7642H965DT52CKJ,STHK72DKQ964C9842|sv|o|mb|p|mb|1C|mb|1S|mb|p|mb|p|mb|1N|mb|p|mb|p|mb|p|pg||
pc|s5|pc|s2|pc|sT|pc|sQ|pg||
pc|d3|pc|dJ|pc|d2|pc|d6|pg||
pc|hJ|pc|h5|pc|h7|pc|hQ|pg||
pc|h4|pc|hT|pc|h9|pc|hK|pg||
pc|dK|pc|dA|pc|d8|pc|d5|pg||
pc|c3|pc|c5|pc|cK|pc|c2|pg||
pc|cJ|pc|c4|pc|cA|pc|c6|pg||
pc|cQ|pc|c7|pc|s4|pc|c8|pg||
pc|cT|pc|s3|pc|s6|pc|c9|pg||
pc|hA|pc|h3|pc|h6|pc|h2|pg||
pc|h8|pc|s8|pc|s7|pc|d4|pg||
pc|d7|pc|sK|pc|dT|pc|dQ|pg||
pc|d9|pc|s9|pc|sA|pc|sJ|pg||
pg||
qx|o15|st||md|1SK87HDAQ742CKQ764,SQ95HQ9873D98CAJ3,SAJHAJ54DKT53C952,ST6432HKT62DJ6CT8|sv|n|mb|1D|mb|p|mb|1H|mb|p|mb|2C|mb|p|mb|2S|mb|p|mb|3S|mb|p|mb|3N|mb|p|mb|p|mb|p|pg||
pc|s3|pc|s7|pc|s5|pc|sJ|pg||
pc|d3|pc|d6|pc|dQ|pc|d8|pg||
pc|d2|pc|d9|pc|dK|pc|dJ|pg||
pc|c5|pc|c8|pc|cK|pc|cA|pg||
pc|h7|pc|hJ|pc|hK|pc|c4|pg||
pc|h6|pc|c6|pc|hQ|pc|hA|pg||
pc|sA|pc|s4|pc|s8|pc|s9|pg||
pc|c9|pc|cT|pc|cQ|pc|c3|pg||
pc|dA|pc|h3|pc|dT|pc|s2|pg||
pc|d7|pc|h8|pc|d5|pc|h2|pg||
pc|d4|pc|h9|pc|c2|pc|hT|pg||
pc|sK|pc|sQ|pc|h4|pc|s6|pg||
pc|c7|pc|cJ|pc|h5|pc|sT|pg||
pg||
qx|c15|st||md|1SK87HDAQ742CKQ764,SQ95HQ9873D98CAJ3,SAJHAJ54DKT53C952,ST6432HKT62DJ6CT8|sv|n|mb|1D|mb|1H|mb|3N|mb|p|mb|4C|mb|p|mb|4D|mb|p|mb|4H|mb|p|mb|4S|mb|p|mb|6D|mb|p|mb|p|mb|p|pg||
pc|s5|pc|sJ|pc|s4|pc|s7|pg||
pc|c2|pc|c8|pc|cK|pc|cA|pg||
pc|s9|pc|sA|pc|s2|pc|s8|pg||
pc|d3|pc|d6|pc|dA|pc|d8|pg||
pc|d2|pc|d9|pc|dK|pc|dJ|pg||
pc|c5|pc|cT|pc|cQ|pc|c3|pg||
pc|sK|pc|sQ|pc|c9|pc|s3|pg||
pc|c4|pc|cJ|pc|d5|pc|h2|pg||
mc|12|pg||
qx|o16|st||md|2S842HQJ62DKQ97C72,SKT5HAK8DJT4CAQJ3,SAJ7H9754D6CKT984,SQ963HT3DA8532C65|sv|e|mb|1C|mb|p|mb|1S|mb|p|mb|2N|mb|p|mb|3N|mb|p|mb|p|mb|p|pg||
pc|cT|pc|c6|pc|c2|pc|cQ|pg||
pc|dJ|pc|d6|pc|d2|pc|dK|pg||
pc|c7|pc|cA|pc|c4|pc|c5|pg||
pc|dT|pc|h4|pc|d3|pc|dQ|pg||
pc|h2|pc|hA|pc|h5|pc|h3|pg||
pc|sK|pc|sA|pc|s3|pc|s2|pg||
pc|h7|pc|hT|pc|hQ|pc|hK|pg||
pc|sT|pc|s7|pc|s6|pc|s4|pg||
pc|s5|pc|sJ|pc|sQ|pc|s8|pg||
pc|s9|pc|h6|pc|d4|pc|c8|pg||
pc|dA|pc|d7|pc|c3|pc|h9|pg||
pc|d5|pc|d9|pc|cJ|pc|c9|pg||
pc|hJ|pc|h8|pc|cK|pc|d8|pg||
pg||