vg|41st WBTC-BBO2,VC-F4,I,17,32,ENGLAND,107,USA2,112|
rs|4HW=,3NE+2,4HE+1,4HE+1,3NW-2,3NW-2,2SE-1,4HS-2,4HN=,1NE-1,3NS=,3NS+1,2SS-2,2SS-2,3SE-2,3SE-2,3NW=,3NW=,2NE-2,1NE-1,3NN+3,3NN+2,3HS-1,4SE=,4HS+1,4SS+1,3SS=,4SN-1,2NN=,3DS-1,5DS=,2HW-1|
pn|SMITH,LEVIN,BROCK,WOLPERT,MEYERS,DHONDY,ZUR-CAMPAN,SENIOR|pg||
qx|o17|st||md|3S643HQJ86DAT7CT76,SAKJT8HK74DKJ3CA9,SQ95H2D98542CQJ43,S72HAT953DQ6CK852|sv|o|mb|p|mb|p|mb|p|mb|2N|mb|p|mb|3D|mb|p|mb|3H|mb|p|mb|3N|mb|p|mb|4H|mb|p|mb|p|mb|p|pg||
pc|cQ|pc|c2|pc|c6|pc|cA|pg||
pc|d3|pc|d2|pc|dQ|pc|dA|pg||
pc|s4|pc|sA|pc|s5|pc|s2|pg||
pc|hK|pc|h2|pc|h3|pc|h6|pg||
pc|h4|pc|d4|pc|hA|pc|h8|pg||
pc|cK|pc|c7|pc|c9|pc|c3|pg||
pc|c5|pc|cT|pc|h7|pc|c4|pg||
pc|dK|pc|d5|pc|d6|pc|d7|pg||
pc|dJ|pc|d8|pc|c8|pc|dT|pg||
mc|10|pg||
qx|c17|st||md|3S643HQJ86DAT7CT76,SAKJT8HK74DKJ3CA9,SQ95H2D98542CQJ43,S72HAT953DQ6CK852|sv|o|mb|p|mb|p|mb|p|mb|1S|mb|p|mb|1N|mb|p|mb|3N|mb|p|mb|p|mb|p|pg||
pc|hJ|pc|hK|pc|h2|pc|h3|pg||
pc|h4|pc|d9|pc|h9|pc|hQ|pg||
pc|c6|pc|c9|pc|cJ|pc|cK|pg||
pc|dQ|pc|dA|pc|d3|pc|d5|pg||
pc|s3|pc|sA|pc|s5|pc|s7|pg||
pc|cA|pc|c3|pc|c2|pc|c7|pg||
pc|dK|pc|d2|pc|d6|pc|d7|pg||
pc|dJ|pc|d4|pc|c5|pc|dT|pg||
pc|h7|pc|d8|pc|hA|pc|h6|pg||
pc|hT|pc|h8|pc|s8|pc|c4|pg||
pc|h5|pc|s4|pc|sT|pc|s9|pg||
pc|s2|pc|s6|pc|sK|pc|sQ|pg||
pc|sJ|pc|cQ|pc|c8|pc|cT|pg||
pg||
qx|o18|st||md|4SKQJ65H74DJ76CT85,SAT83HKQTD9852CQ4,S942HJ92DKCAJ9732,S7HA8653DAQT43CK6|sv|n|mb|1H|mb|p|mb|1N|mb|2C|mb|2D|mb|2S|mb|4H|mb|p|mb|p|mb|p|pg||
pc|sK|pc|sA|pc|s2|pc|s7|pg||
pc|hK|pc|h2|pc|h3|pc|h4|pg||
pc|hT|pc|h9|pc|hA|pc|h7|pg||
pc|dA|pc|d7|pc|d2|pc|dK|pg||
pc|h5|pc|s6|pc|hQ|pc|hJ|pg||
pc|d9|pc|c3|pc|dQ|pc|d6|pg||
pc|d3|pc|dJ|pc|d5|pc|c2|pg||
mc|11|pg||
qx|c18|st||md|4SKQJ65H74DJ76CT85,SAT83HKQTD9852CQ4,S942HJ92DKCAJ9732,S7HA8653DAQT43CK6|sv|n|mb|1H|mb|p|mb|2S|mb|p|mb|4H|mb|p|mb|p|mb|p|pg||
pc|sK|pc|sA|pc|s4|pc|s7|pg||
pc|hK|pc|h2|pc|h5|pc|h7|pg||
pc|hQ|pc|h9|pc|h3|pc|h4|pg||
pc|d2|pc|dK|pc|dA|pc|d7|pg||
pc|hA|pc|s6|pc|hT|pc|hJ|pg||
pc|dQ|pc|d6|pc|d5|pc|c2|pg||
pc|d3|pc|dJ|pc|d9|pc|c3|pg||
mc|11|pg||
qx|o19|st||md|1SJ632H432D652CA42,SKQ75HJ75DK987C86,SAT984HK986DJ4CQT,SHAQTDAQT3CKJ9753|sv|e|mb|p|mb|p|mb|1S|mb|2C|mb|3S|mb|p|mb|p|mb|d|mb|p|mb|3N|mb|p|mb|p|mb|p|pg||
pc|sT|pc|c3|pc|s3|pc|sK|pg||
pc|c6|pc|cT|pc|cK|pc|cA|pg||
pc|sJ|pc|sQ|pc|sA|pc|c5|pg||
pc|s9|pc|c7|pc|s6|pc|s5|pg||
pc|s8|pc|dT|pc|s2|pc|s7|pg||
pc|s4|pc|hT|pc|c4|pc|c8|pg||
pc|cQ|pc|c9|pc|c2|pc|h5|pg||
pc|d4|pc|dA|pc|d2|pc|d7|pg||
pc|dQ|pc|d5|pc|d8|pc|dJ|pg||
mc|7|pg||
qx|c19|st||md|1SJ632H432D652CA42,SKQ75HJ75DK987C86,SAT984HK986DJ4CQT,SHAQTDAQT3CKJ9753|sv|e|mb|p|mb|p|mb|1S|mb|2C|mb|3S|mb|p|mb|p|mb|d|mb|p|mb|3N|mb|p|mb|p|mb|p|pg||
pc|sT|pc|c3|pc|s2|pc|sK|pg||
pc|c6|pc|cT|pc|cK|pc|cA|pg||
pc|sJ|pc|sQ|pc|sA|pc|d3|pg||
pc|s9|pc|c5|pc|s3|pc|s5|pg||
pc|s8|pc|c7|pc|s6|pc|s7|pg||
pc|s4|pc|dT|pc|d6|pc|h5|pg||
pc|cQ|pc|c9|pc|c2|pc|c8|pg||
pc|d4|pc|dA|pc|d2|pc|d7|pg||
pc|dQ|pc|d5|pc|dK|pc|dJ|pg||
pc|hJ|pc|h6|pc|hT|pc|h3|pg||
pc|h7|mc|7|pg||
qx|o20|st||md|2SJ76HKJ9862D85C93,ST32H43DA94CAKQ74,SAK8HAT7DQJ732CJ6,SQ954HQ5DKT6CT852|sv|b|mb|1C|mb|1D|mb|1S|mb|p|mb|2S|mb|p|mb|p|mb|p|pg||
pc|d8|pc|d4|pc|dJ|pc|dK|pg||
pc|c2|pc|c3|pc|cA|pc|c6|pg||
pc|s2|pc|s8|pc|s9|pc|sJ|pg||
pc|d5|pc|dA|pc|d3|pc|d6|pg||
pc|sT|pc|sK|pc|s4|pc|s6|pg||
pc|dQ|pc|dT|pc|c9|pc|d9|pg||
pc|d7|pc|h5|pc|s7|pc|h3|pg||
pc|h8|pc|h4|pc|hA|pc|hQ|pg||
pc|sA|pc|s5|pc|h2|pc|s3|pg||
pc|hT|mc|7|pg||
qx|c20|st||md|2SJ76HKJ9862D85C93,ST32H43DA94CAKQ74,SAK8HAT7DQJ732CJ6,SQ954HQ5DKT6CT852|sv|b|mb|1C|mb|d|mb|1S|mb|3H|mb|p|mb|4H|mb|p|mb|p|mb|p|pg||
pc|cK|pc|c6|pc|c2|pc|c3|pg||
pc|s2|pc|s8|pc|sQ|pc|s7|pg||
pc|c5|pc|c9|pc|cQ|pc|cJ|pg||
pc|dA|pc|d2|pc|d6|pc|d5|pg||
pc|d9|pc|dQ|pc|dK|pc|d8|pg||
pc|dT|pc|hJ|pc|d4|pc|d3|pg||
pc|h2|pc|h3|pc|hA|pc|h5|pg||
pc|h7|pc|hQ|pc|hK|pc|h4|pg||
mc|8|pg||
qx|o21|st||md|3S6HA87542DQ984CA8,SQT75HT9DJT2CJ765,SA942HJ63D53CKQT3,SKJ83HKQDAK76C942|sv|n|mb|p|mb|1N|mb|2D|mb|p|mb|3H|mb|p|mb|4H|mb|p|mb|p|mb|p|pg||
pc|dA|pc|d4|pc|dJ|pc|d5|pg||
pc|hK|pc|hA|pc|hT|pc|h3|pg||
pc|h2|pc|h9|pc|hJ|pc|hQ|pg||
pc|s3|pc|s6|pc|sQ|pc|sA|pg||
pc|d3|pc|dK|pc|d8|pc|d2|pg||
mc|10|pg||
qx|c21|st||md|3S6HA87542DQ984CA8,SQT75HT9DJT2CJ765,SA942HJ63D53CKQT3,SKJ83HKQDAK76C942|sv|n|mb|p|mb|1N|mb|p|mb|p|mb|p|pg||
pc|h5|pc|h9|pc|hJ|pc|hQ|pg||
pc|s3|pc|s6|pc|sQ|pc|sA|pg||
pc|h6|pc|hK|pc|hA|pc|hT|pg||
pc|h2|pc|s5|pc|h3|pc|d6|pg||
pc|d5|pc|dA|pc|d4|pc|d2|pg||
pc|sJ|pc|c8|pc|s7|pc|s2|pg||
pc|s8|pc|d8|pc|sT|pc|s4|pg||
pc|dT|pc|d3|pc|dK|pc|d9|pg||
pc|sK|pc|h4|pc|dJ|pc|s9|pg||
mc|6|pg||
qx|o22|st||md|4SKJ74HA86DA5CK964,ST8HJT9743DJ7CAT5,S932HKQ5DKQ432CJ8,SAQ65H2DT986CQ732|sv|e|mb|p|mb|1N|mb|p|mb|3N|mb|p|mb|p|mb|p|pg||
pc|hJ|pc|h5|pc|h2|pc|hA|pg||
pc|dA|pc|d7|pc|d2|pc|d6|pg||
pc|d5|pc|dJ|pc|dK|pc|dT|pg||
pc|dQ|pc|d8|pc|s4|pc|h3|pg||
pc|d3|pc|d9|pc|c4|pc|h4|pg||
pc|c2|pc|c6|pc|cA|pc|c8|pg||
pc|cT|pc|cJ|pc|cQ|pc|cK|pg||
pc|c9|pc|c5|pc|s2|pc|c3|pg||
pc|h6|pc|h7|pc|hQ|pc|s5|pg||
pc|hK|pc|s6|pc|h8|pc|h9|pg||
pc|d4|pc|sQ|pc|s7|pc|s8|pg||
pc|s3|pc|sA|pc|sJ|pc|sT|pg||
pc|c7|pc|sK|pc|hT|pc|s9|pg||
pg||
qx|c22|st||md|4SKJ74HA86DA5CK964,ST8HJT9743DJ7CAT5,S932HKQ5DKQ432CJ8,SAQ65H2DT986CQ732|sv|e|mb|p|mb|1N|mb|p|mb|3C|mb|p|mb|3D|mb|p|mb|3N|mb|p|mb|p|mb|p|pg||
pc|hJ|pc|h5|pc|h2|pc|hA|pg||
pc|dA|pc|d7|pc|d2|pc|d6|pg||
pc|d5|pc|dJ|pc|dK|pc|dT|pg||
pc|dQ|pc|d8|pc|c4|pc|h4|pg||
pc|d3|pc|d9|pc|s4|pc|h3|pg||
pc|s5|pc|sJ|pc|s8|pc|s2|pg||
pc|h6|pc|h7|pc|hQ|pc|c2|pg||
pc|s3|pc|sA|pc|s7|pc|sT|pg||
pc|c3|pc|c6|pc|cA|pc|c8|pg||
mc|10|pg||
qx|o23|st||md|1SHDC,SHDC,SHDC,SHDC|sv|b|mb|1S|mb|p|mb|2H|mb|p|mb|2S|mb|p|mb|p|mb|p|pg||
pc|c3|pc|c2|pc|cT|pc|cJ|pg||
pc|h6|pc|h9|pc|hT|pc|hK|pg||
pc|c6|pc|c9|pc|c5|pc|cK|pg||
pc|sJ|pc|s2|pc|sA|pc|s4|pg||
pc|sK|pc|sT|pc|s5|pc|s6|pg||
pc|s8|pc|c4|pc|h3|pc|sQ|pg||
pc|d2|pc|dK|pc|dA|pc|d5|pg||
pc|c8|pc|cA|pc|s7|pc|c7|pg||
pc|hA|pc|s3|pc|h4|pc|h5|pg||
pc|d4|pc|d8|pc|d9|pc|dQ|pg||
pc|h2|pc|s9|pc|hQ|pc|h7|pg||
pc|d6|pc|dJ|pc|dT|pc|d3|pg||
pc|cQ|pc|hJ|pc|h8|pc|d7|pg||
pg||
qx|c23|st||md|1SHDC,SHDC,SHDC,SHDC|sv|b|mb|1S|mb|p|mb|1N|mb|p|mb|2D|mb|p|mb|2S|mb|p|mb|p|mb|p|pg||
pc|c4|pc|c2|pc|cT|pc|cJ|pg||
pc|s3|pc|s4|pc|sJ|pc|sQ|pg||
pc|hK|pc|h6|pc|h9|pc|h3|pg||
pc|c6|pc|c7|pc|c3|pc|cK|pg||
pc|h5|pc|h2|pc|s8|pc|h4|pg||
pc|c9|pc|c5|pc|cA|pc|s2|pg||
pc|h8|pc|s9|pc|hQ|pc|h7|pg||
pc|sA|pc|sT|pc|s5|pc|s6|pg||
pc|sK|pc|d8|pc|hT|pc|s7|pg||
pc|d4|pc|dJ|pc|d5|pc|d3|pg||
pc|cQ|pc|hJ|pc|hA|pc|d6|pg||
pc|c8|pc|d9|pc|d2|pc|d7|pg||
pc|dA|pc|dT|pc|dQ|pc|dK|pg||
pg||
qx|o24|st||md|2SKQ9HKJ72DA85C732,SJ853HA86DK973CAQ,S6HQ93DQ2CKJT8654,SAT742HT54DJT64C9|sv|o|mb|1D|mb|p|mb|1S|mb|p|mb|2S|mb|3C|mb|3S|mb|p|mb|p|mb|p|pg||
pc|c2|pc|cQ|pc|cK|pc|c9|pg||
pc|c8|pc|h4|pc|c7|pc|cA|pg||
pc|s3|pc|s6|pc|sA|pc|s9|pg||
pc|s2|pc|sQ|pc|s5|pc|c5|pg||
pc|sK|pc|s8|pc|c6|pc|s4|pg||
pc|d5|pc|d3|pc|dQ|pc|d4|pg||
pc|h3|pc|h5|pc|hJ|pc|hA|pg||
pc|d7|pc|d2|pc|dJ|pc|dA|pg||
pc|hK|pc|h6|pc|h9|pc|hT|pg||
pc|h2|pc|h8|pc|hQ|pc|s7|pg||
mc|7|pg||
qx|c24|st||md|2SKQ9HKJ72DA85C732,SJ853HA86DK973CAQ,S6HQ93DQ2CKJT8654,SAT742HT54DJT64C9|sv|o|mb|p|mb|p|mb|3S|mb|p|mb|p|mb|p|pg||
pc|h2|mc|7|pg||
qx|o25|st||md|3SAJ76HK876D96CJ52,S42HAT4DKJ432CAK8,SKQ53HJ52DT75C976,ST98HQ93DAQ8CQT43|sv|e|mb|p|mb|p|mb|p|mb|1N|mb|p|mb|3N|mb|p|mb|p|mb|p|pg||
pc|s3|pc|s8|pc|sA|pc|s2|pg||
pc|s6|pc|s4|pc|sQ|pc|s9|pg||
pc|sK|pc|sT|pc|s7|pc|h4|pg||
pc|s5|pc|h3|pc|sJ|pc|hT|pg||
pc|c2|pc|c8|pc|c9|pc|cT|pg||
mc|9|pg||
qx|c25|st||md|3SAJ76HK876D96CJ52,S42HAT4DKJ432CAK8,SKQ53HJ52DT75C976,ST98HQ93DAQ8CQT43|sv|e|mb|p|mb|p|mb|p|mb|1N|mb|p|mb|3N|mb|p|mb|p|mb|p|pg||
pc|s3|mc|9|pg||
qx|o26|st||md|4SJ64H64DAKQ8CJT76,S8752H72DJT76CAK5,SAT3HQJ85D52C9832,SKQ9HAKT93D943CQ4|sv|b|mb|1N|mb|p|mb|2C|mb|p|mb|2H|mb|p|mb|2N|mb|p|mb|p|mb|p|pg||
pc|dA|pc|d6|pc|d5|pc|d4|pg||
pc|c6|pc|c5|pc|c8|pc|cQ|pg||
pc|hA|pc|h4|pc|h2|pc|h5|pg||
pc|hK|pc|h6|pc|h7|pc|h8|pg||
pc|hT|pc|d8|pc|s2|pc|hJ|pg||
pc|c2|pc|c4|pc|c7|pc|cK|pg||
pc|s5|pc|s3|pc|sK|pc|s4|pg||
pc|h9|pc|s6|pc|s7|pc|hQ|pg||
pc|c9|pc|d3|pc|cT|pc|cA|pg||
pc|s8|pc|sA|pc|s9|pc|sJ|pg||
pc|c3|pc|h3|pc|cJ|pc|d7|pg||
pc|dK|pc|dT|pc|d2|pc|d9|pg||
pc|dQ|pc|dJ|pc|sT|pc|sQ|pg||
pg||
qx|c26|st||md|4SJ64H64DAKQ8CJT76,S8752H72DJT76CAK5,SAT3HQJ85D52C9832,SKQ9HAKT93D943CQ4|sv|b|mb|1H|mb|p|mb|1S|mb|p|mb|1N|mb|p|mb|p|mb|p|pg||
pc|dQ|pc|d6|pc|d2|pc|d4|pg||
pc|c6|pc|cA|pc|c8|pc|c4|pg||
pc|h2|pc|h5|pc|hA|pc|h4|pg||
pc|hK|pc|h6|pc|h7|pc|h8|pg||
pc|hT|pc|s6|pc|s2|pc|hJ|pg||
pc|c2|pc|cQ|pc|c7|pc|c5|pg||
pc|h3|pc|d8|pc|s5|pc|hQ|pg||
pc|c3|pc|s9|pc|cT|pc|cK|pg||
pc|s7|pc|sA|pc|sQ|pc|s4|pg||
pc|c9|pc|d3|pc|cJ|pc|s8|pg||
pc|dA|pc|d7|pc|d5|pc|d9|pg||
pc|dK|pc|dT|pc|s3|pc|h9|pg||
pc|sJ|pc|dJ|pc|sT|pc|sK|pg||
pg||
qx|o27|st||md|1S2HQ54D65CAQJT765,S843HJ2DJ9743CK84,SAKQJTHAT9DAKT2C2,S9765HK8763DQ8C93|sv|o|mb|3C|mb|p|mb|3N|mb|p|mb|p|mb|p|pg||
pc|h6|pc|h4|pc|hJ|pc|hA|pg||
pc|c2|pc|c3|pc|cQ|pc|c4|pg||
pc|s2|pc|s4|pc|sA|pc|s5|pg||
pc|sK|pc|s6|pc|c5|pc|s3|pg||
pc|sQ|pc|s7|pc|c6|pc|s8|pg||
pc|sJ|pc|s9|pc|d5|pc|d7|pg||
pc|sT|pc|h8|pc|c7|pc|h2|pg||
pc|h9|pc|hK|pc|h5|pc|d3|pg||
pc|h3|pc|hQ|pc|d4|pc|hT|pg||
pc|cA|pc|c8|pc|d2|pc|c9|pg||
pc|d6|pc|d9|pc|dA|pc|d8|pg||
pc|dK|pc|dQ|pc|cT|pc|dJ|pg||
pc|dT|pc|h7|pc|cJ|pc|cK|pg||
pg||
qx|c27|st||md|1S2HQ54D65CAQJT765,S843HJ2DJ9743CK84,SAKQJTHAT9DAKT2C2,S9765HK8763DQ8C93|sv|o|mb|3C|mb|p|mb|3N|mb|p|mb|p|mb|p|pg||
pc|h6|pc|h4|pc|hJ|pc|hA|pg||
pc|sA|pc|s5|pc|s2|pc|s4|pg||
pc|sK|pc|s6|pc|c5|pc|s3|pg||
pc|sQ|pc|s7|pc|c6|pc|s8|pg||
pc|sJ|pc|s9|pc|c7|pc|d7|pg||
pc|sT|pc|c3|pc|cT|pc|c8|pg||
pc|hT|pc|hK|pc|h5|pc|h2|pg||
pc|dQ|pc|d5|pc|d3|pc|dA|pg||
pc|c2|pc|c9|pc|cJ|pc|cK|pg||
mc|11|pg||
qx|o28|st||md|2SQ6HAK9753DK72C86,SKJ2HQ64DAT63CA52,S954HJT8DQ8CKJ943,SAT873H2DJ954CQT7|sv|n|mb|1D|mb|p|mb|1S|mb|2H|mb|d|mb|3H|mb|p|mb|p|mb|p|pg||
pc|s2|pc|s4|pc|sA|pc|s6|pg||
pc|d9|pc|d7|pc|d3|pc|dQ|pg||
pc|h8|pc|h2|pc|hK|pc|h4|pg||
pc|d2|pc|dT|pc|d8|pc|dJ|pg||
pc|s7|pc|sQ|pc|sK|pc|s5|pg||
pc|sJ|pc|s9|pc|s3|pc|h5|pg||
pc|c6|pc|cA|pc|c3|pc|c7|pg||
pc|c5|pc|cK|pc|cT|pc|c8|pg||
pc|hT|pc|s8|pc|hA|pc|h6|pg||
pc|dK|pc|dA|pc|hJ|pc|d5|pg||
mc|8|pg||
qx|c28|st||md|2SQ6HAK9753DK72C86,SKJ2HQ64DAT63CA52,S954HJT8DQ8CKJ943,SAT873H2DJ954CQT7|sv|n|mb|1C|mb|p|mb|1S|mb|2H|mb|d|mb|3H|mb|3S|mb|p|mb|4S|mb|p|mb|p|mb|p|pg||
pc|hK|pc|h4|pc|h8|pc|h2|pg||
pc|c8|pc|c2|pc|cK|pc|c7|pg||
pc|c4|pc|cQ|pc|c6|pc|c5|pg||
pc|s3|pc|s6|pc|sJ|pc|s4|pg||
pc|sK|pc|s5|pc|s7|pc|sQ|pg||
pc|s2|pc|s9|pc|sT|pc|h3|pg||
pc|d4|pc|d2|pc|dT|pc|dQ|pg||
pc|hJ|pc|s8|pc|h5|pc|h6|pg||
pc|dJ|pc|d7|pc|d3|pc|d8|pg||
mc|10|pg||
qx|o29|st||md|3SAT653HT87654DKC6,SJ4HJ2DQ643CAJT84,SKQ2HAK93D9875C93,S987HQDAJT2CKQ752|sv|b|mb|1C|mb|p|mb|1H|mb|p|mb|1S|mb|p|mb|2H|mb|p|mb|3H|mb|p|mb|4H|mb|p|mb|p|mb|p|pg||
pc|d4|pc|d5|pc|dA|pc|dK|pg||
pc|cK|pc|c6|pc|c4|pc|c3|pg||
pc|c5|pc|h4|pc|cT|pc|c9|pg||
pc|h5|pc|h2|pc|hA|pc|hQ|pg||
pc|hK|pc|c2|pc|h6|pc|hJ|pg||
mc|11|pg||
qx|c29|st||md|3SAT653HT87654DKC6,SJ4HJ2DQ643CAJT84,SKQ2HAK93D9875C93,S987HQDAJT2CKQ752|sv|b|mb|1D|mb|p|mb|1S|mb|p|mb|2S|mb|p|mb|4S|mb|p|mb|p|mb|p|pg||
pc|hJ|pc|hA|pc|hQ|pc|h5|pg||
pc|sK|pc|s8|pc|s3|pc|s4|pg||
pc|sQ|pc|s7|pc|s5|pc|sJ|pg||
pc|s2|pc|s9|pc|sA|pc|c8|pg||
pc|h8|pc|h2|pc|h9|pc|c7|pg||
pc|d5|pc|dA|pc|dK|pc|d3|pg||
mc|11|pg||
qx|o30|st||md|4SAKQJ73H743DK7CKT,S4HJ982DAT843C852,S9852HKT5DQ52CJ97,ST6HAQ6DJ96CAQ643|sv|o|mb|1N|mb|2D|mb|p|mb|2H|mb|p|mb|2S|mb|d|mb|p|mb|3C|mb|3S|mb|p|mb|p|mb|p|pg||
pc|c2|pc|c7|pc|cQ|pc|cK|pg||
pc|sA|pc|s4|pc|s2|pc|s6|pg||
pc|sK|pc|d3|pc|s5|pc|sT|pg||
pc|cT|pc|c8|pc|c9|pc|cA|pg||
pc|dJ|pc|dK|pc|dA|pc|d2|pg||
pc|hJ|pc|hK|pc|hA|pc|h4|pg||
pc|hQ|pc|h3|pc|h2|pc|h5|pg||
mc|9|pg||
qx|c30|st||md|4SAKQJ73H743DK7CKT,S4HJ982DAT843C852,S9852HKT5DQ52CJ97,ST6HAQ6DJ96CAQ643|sv|o|mb|1C|mb|d|mb|p|mb|1S|mb|p|mb|3S|mb|p|mb|4S|mb|p|mb|p|mb|p|pg||
pc|d6|pc|d7|pc|dA|pc|d2|pg||
pc|h9|pc|hT|pc|hQ|pc|h3|pg||
pc|hA|pc|h4|pc|h2|pc|h5|pg||
pc|cA|pc|cT|pc|c2|pc|c7|pg||
pc|h6|pc|h7|pc|h8|pc|hK|pg||
mc|9|pg||
qx|o31|st||md|1SA85H8DAT9854CKT9,S9743HA6DKJ73CA53,SKQJHQ9743DCQJ764,ST62HKJT52DQ62C82|sv|n|mb|1D|mb|p|mb|1H|mb|p|mb|2D|mb|p|mb|2N|mb|p|mb|p|mb|p|pg||
pc|h5|pc|h8|pc|hA|pc|h3|pg||
pc|s7|pc|sK|pc|s6|pc|s5|pg||
pc|c4|pc|c8|pc|cK|pc|c5|pg||
pc|cT|pc|c3|pc|c6|pc|c2|pg||
pc|c9|pc|cA|pc|c7|pc|s2|pg||
pc|h6|pc|h7|pc|hT|pc|d4|pg||
pc|d2|pc|dA|pc|d3|pc|h4|pg||
pc|s8|pc|s3|pc|sQ|pc|sT|pg||
pc|cQ|pc|h2|pc|d5|pc|d7|pg||
pc|cJ|pc|hJ|pc|d8|pc|s4|pg||
pc|sJ|pc|d6|pc|sA|pc|s9|pg||
pc|dT|pc|dJ|pc|h9|pc|dQ|pg||
pc|hK|pc|d9|pc|dK|pc|hQ|pg||
pg||
qx|c31|st||md|1SA85H8DAT9854CKT9,S9743HA6DKJ73CA53,SKQJHQ9743DCQJ764,ST62HKJT52DQ62C82|sv|n|mb|1D|mb|p|mb|1H|mb|p|mb|2D|mb|p|mb|2N|mb|p|mb|3D|mb|p|mb|p|mb|p|pg||
pc|s7|pc|sJ|pc|sT|pc|sA|pg||
pc|dA|pc|d3|pc|c4|pc|d2|pg||
pc|d8|pc|d7|pc|h3|pc|dQ|pg||
pc|s6|pc|s8|pc|s3|pc|sQ|pg||
pc|c6|pc|c2|pc|cK|pc|cA|pg||
pc|hA|pc|h4|pc|h2|pc|h8|pg||
pc|h6|pc|h7|pc|hT|pc|d4|pg||
pc|d9|pc|dJ|pc|h9|pc|d6|pg||
pc|s4|pc|sK|pc|s2|pc|s5|pg||
mc|8|pg||
qx|o32|st||md|2SAQ653H6DAK6CQT97,SKJ94HQJ8543D93C2,STHK92DT87542CA54,S872HAT7DQJCKJ863|sv|e|mb|p|mb|2C|mb|p|mb|2S|mb|p|mb|3C|mb|p|mb|5D|mb|p|mb|p|mb|p|pg||
pc|c2|pc|c4|pc|cK|pc|c7|pg||
pc|dQ|pc|dA|pc|d3|pc|d2|pg||
pc|h6|pc|h3|pc|hK|pc|hA|pg||
pc|h7|pc|d6|pc|h4|pc|h2|pg||
pc|sA|pc|s4|pc|sT|pc|s7|pg||
pc|s5|pc|s9|pc|d4|pc|s8|pg||
pc|d5|pc|dJ|pc|dK|pc|d9|pg||
pc|s3|pc|sJ|pc|d7|pc|s2|pg||
pc|dT|pc|c8|pc|s6|pc|h5|pg||
pc|cA|pc|c6|pc|c9|pc|h8|pg||
pc|c5|pc|c3|pc|cT|pc|hJ|pg||
pc|cQ|pc|hQ|pc|h9|pc|cJ|pg||
pc|sQ|pc|sK|pc|d8|pc|hT|pg||
pg||
qx|c32|st||md|2SAQ653H6DAK6CQT97,SKJ94HQJ8543D93C2,STHK92DT87542CA54,S872HAT7DQJCKJ863|sv|e|mb|p|mb|p|mb|1C|mb|1S|mb|d|mb|p|mb|2C|mb|p|mb|2H|mb|p|mb|p|mb|p|pg||
pc|sT|pc|s2|pc|sA|pc|s4|pg||
pc|s6|pc|s9|pc|h2|pc|s7|pg||
pc|d8|pc|dJ|pc|dK|pc|d3|pg||
pc|s5|pc|sJ|pc|h9|pc|s8|pg||
pc|d5|pc|dQ|pc|dA|pc|d9|pg||
pc|c7|pc|c2|pc|cA|pc|c3|pg||
pc|d2|pc|c6|pc|d6|pc|h4|pg||
pc|hQ|pc|hK|pc|hA|pc|h6|pg||
mc|7|pg||