vg|41st WBTC-BBO3,VC-SF5,I,1,16,USA2,121,NETHERLANDS,109|
rs|3NN=,6CN-2,2SW-1,2DE=,2DSx=,3NE-4,2SW=,2SW=,2NN-1,1NN=,1NW+1,1NSx-2,2HS+1,2HS+1,5DE-2,3HS=,4SW-1,4SW-1,4SWx-1,4SWx-1,1NW+1,2SN-1,4HS+1,4HS=,4SS+1,4SS+1,4SE=,4SE-1,4SW+2,4SW+1,3CW-1,3NE-1|
pn|MEYERS,VAN ZWOL,ZUR-CAMPAN,ARNOLDS,MICHIELSEN,EYTHORSDOT,WORTEL,SEAMON-MOL|pg||
qx|o1|st||md|3S9HAQ8754DA7CJT96,SKQT52H6DQJ54CA85,SAJ63HKDKT98CKQ32,S874HJT932D632C74|sv|o|mb|1D|mb|p|mb|1H|mb|1S|mb|2C|mb|p|mb|2S|mb|d|mb|3N|mb|p|mb|p|mb|p|pg||
pc|s4|pc|s9|pc|sQ|pc|sA|pg||
pc|c2|pc|c4|pc|cJ|pc|c8|pg||
pc|c6|pc|c5|pc|cK|pc|c7|pg||
pc|hK|pc|h2|pc|h4|pc|h6|pg||
pc|d8|pc|d2|pc|dA|pc|d4|pg||
pc|hA|pc|s2|pc|d9|pc|h3|pg||
pc|cT|pc|cA|pc|cQ|pc|h9|pg||
pc|d5|pc|dK|pc|d3|pc|d7|pg||
pc|c3|pc|s7|pc|c9|pc|s5|pg||
pc|hQ|pc|sT|pc|s3|pc|hT|pg||
pc|h5|pc|dJ|pc|dT|pc|hJ|pg||
pc|s8|pc|h7|pc|sK|pc|s6|pg||
pc|dQ|pc|sJ|pc|d6|pc|h8|pg||
pg||
qx|c1|st||md|3S9HAQ8754DA7CJT96,SKQT52H6DQJ54CA85,SAJ63HKDKT98CKQ32,S874HJT932D632C74|sv|o|mb|1C|mb|p|mb|1D|mb|1S|mb|p|mb|p|mb|2S|mb|p|mb|3N|mb|p|mb|4C|mb|p|mb|4D|mb|p|mb|4H|mb|p|mb|4S|mb|p|mb|4N|mb|p|mb|5S|mb|p|mb|6C|mb|p|mb|p|mb|p|pg||
pc|c7|pc|c6|pc|cA|pc|c2|pg||
pc|c5|pc|cK|pc|c4|pc|c9|pg||
pc|hK|pc|h2|pc|h4|pc|h6|pg||
pc|d8|pc|d2|pc|dA|pc|d4|pg||
pc|h5|pc|s2|pc|c3|pc|h3|pg||
pc|dK|pc|d3|pc|d7|pc|d5|pg||
pc|d9|pc|d6|pc|cT|pc|dQ|pg||
pc|hA|pc|c8|pc|cQ|pc|h9|pg||
pc|sA|pc|s4|pc|s9|pc|s5|pg||
mc|10|pg||
qx|o2|st||md|4SKJ2H986DJ92CA986,ST9543HJ532DKQ53C,SA876HA74DT8CKQT5,SQHKQTDA764CJ7432|sv|n|mb|1C|mb|p|mb|1S|mb|p|mb|1N|mb|p|mb|2D|mb|p|mb|2S|mb|p|mb|p|mb|p|pg||
pc|dT|pc|dA|pc|d2|pc|d3|pg||
pc|sQ|pc|sK|pc|s3|pc|s6|pg||
pc|d9|pc|dK|pc|d8|pc|d4|pg||
pc|sT|pc|sA|pc|c2|pc|s2|pg||
pc|c5|pc|c3|pc|cA|pc|s4|pg||
pc|h2|pc|hA|pc|hT|pc|h9|pg||
pc|cK|pc|c4|pc|c6|pc|s5|pg||
pc|h3|pc|h7|pc|hK|pc|h8|pg||
pc|c7|pc|c8|pc|s9|pc|cT|pg||
pc|h5|pc|h4|pc|hQ|pc|h6|pg||
pc|d6|pc|dJ|pc|dQ|pc|s7|pg||
pc|cQ|pc|cJ|pc|c9|pc|d5|pg||
pc|s8|pc|d7|pc|sJ|pc|hJ|pg||
pg||
qx|c2|st||md|4SKJ2H986DJ92CA986,ST9543HJ532DKQ53C,SA876HA74DT8CKQT5,SQHKQTDA764CJ7432|sv|n|mb|1D|mb|p|mb|1S|mb|p|mb|2C|mb|p|mb|2D|mb|p|mb|p|mb|p|pg||
pc|h6|pc|h2|pc|hA|pc|hQ|pg||
pc|d8|pc|d4|pc|d2|pc|dK|pg||
pc|s3|pc|s6|pc|sQ|pc|sK|pg||
pc|d9|pc|d3|pc|dT|pc|dA|pg||
pc|d6|pc|dJ|pc|dQ|pc|h4|pg||
mc|8|pg||
qx|o3|st||md|1S942HKJ5DQT7532C7,SKQJT5H74D986CK32,SA73HT86DJ4CAJT65,S86HAQ932DAKCQ984|sv|e|mb|p|mb|p|mb|1C|mb|1H|mb|p|mb|1S|mb|p|mb|1N|mb|2D|mb|p|mb|p|mb|d|mb|p|mb|p|mb|p|pg||
pc|sK|pc|sA|pc|s6|pc|s4|pg||
pc|h6|pc|hA|pc|h5|pc|h4|pg||
pc|dA|pc|d2|pc|d6|pc|d4|pg||
pc|dK|pc|d3|pc|d8|pc|dJ|pg||
pc|s8|pc|s9|pc|sQ|pc|s3|pg||
pc|sJ|pc|s7|pc|h2|pc|s2|pg||
pc|sT|pc|c5|pc|c4|pc|d5|pg||
pc|dQ|pc|d9|pc|c6|pc|c8|pg||
pc|dT|pc|h7|pc|h8|pc|h3|pg||
pc|c7|pc|c2|pc|cA|pc|c9|pg||
pc|hT|pc|h9|pc|hJ|pc|c3|pg||
mc|8|pg||
qx|c3|st||md|1S942HKJ5DQT7532C7,SKQJT5H74D986CK32,SA73HT86DJ4CAJT65,S86HAQ932DAKCQ984|sv|e|mb|2D|mb|p|mb|p|mb|2H|mb|p|mb|2S|mb|p|mb|3N|mb|p|mb|p|mb|p|pg||
pc|d2|pc|d9|pc|dJ|pc|dK|pg||
pc|s8|pc|s9|pc|sK|pc|s7|pg||
pc|sQ|pc|sA|pc|s6|pc|s2|pg||
pc|d4|pc|dA|pc|d7|pc|d6|pg||
pc|cQ|pc|c7|pc|c2|pc|c5|pg||
pc|c4|pc|s4|pc|cK|pc|cA|pg||
pc|cJ|pc|c8|pc|h5|pc|c3|pg||
pc|cT|pc|c9|pc|d3|pc|d8|pg||
pc|c6|pc|h3|pc|d5|pc|h4|pg||
pc|h8|pc|hQ|pc|hK|pc|h7|pg||
mc|5|pg||
qx|o4|st||md|2SAQHT7532DT8CQJ76,SKJT93HQ9DKQ32CK8,S872HJ4DAJ654CAT9,S654HAK86D97C5432|sv|b|mb|1S|mb|p|mb|2S|mb|p|mb|p|mb|p|pg||
pc|hJ|pc|hA|pc|h3|pc|h9|pg||
pc|d7|pc|d8|pc|dK|pc|dA|pg||
pc|h4|pc|h6|pc|h7|pc|hQ|pg||
pc|dQ|pc|d6|pc|d9|pc|dT|pg||
pc|d2|pc|d4|pc|s4|pc|sQ|pg||
pc|cQ|pc|cK|pc|cA|pc|c2|pg||
pc|cT|pc|c3|pc|c6|pc|c8|pg||
pc|dJ|pc|s5|pc|sA|pc|d3|pg||
pc|h2|mc|8|pg||
qx|c4|st||md|2SAQHT7532DT8CQJ76,SKJT93HQ9DKQ32CK8,S872HJ4DAJ654CAT9,S654HAK86D97C5432|sv|b|mb|1S|mb|p|mb|2S|mb|p|mb|p|mb|p|pg||
pc|hJ|pc|h6|pc|h5|pc|hQ|pg||
pc|h9|pc|h4|pc|hA|pc|h2|pg||
pc|hK|pc|h3|pc|c8|pc|s2|pg||
pc|s7|pc|s4|pc|sA|pc|s9|pg||
pc|hT|pc|sT|pc|d4|pc|h8|pg||
pc|dK|pc|dA|pc|d7|pc|d8|pg||
pc|s8|pc|s5|pc|sQ|pc|sK|pg||
pc|dQ|pc|d5|pc|d9|pc|dT|pg||
pc|d2|pc|d6|pc|s6|pc|c6|pg||
pc|c2|pc|cJ|pc|cK|pc|cA|pg||
pc|dJ|pc|c3|pc|c7|pc|d3|pg||
mc|8|pg||
qx|o5|st||md|3S765HQ63DKQ872C84,SK4HT742DJ6CJT953,SAJ83HJ98DT95CAKQ,SQT92HAK5DA43C762|sv|n|mb|1N|mb|p|mb|2S!|mb|p|mb|2N|mb|p|mb|p|mb|p|pg||
pc|s2|pc|s5|pc|sK|pc|sA|pg||
pc|d9|pc|d4|pc|dK|pc|d6|pg||
pc|c4|pc|cJ|pc|cQ|pc|c7|pg||
pc|dT|pc|d3|pc|dQ|pc|dJ|pg||
pc|d2|pc|c3|pc|d5|pc|dA|pg||
pc|c6|pc|c8|pc|cT|pc|cK|pg||
pc|sJ|pc|sQ|pc|s6|pc|s4|pg||
pc|sT|pc|s7|pc|h2|pc|s3|pg||
pc|s9|pc|d7|pc|h4|pc|s8|pg||
pc|hA|pc|h3|pc|h7|pc|h8|pg||
pc|hK|pc|h6|pc|hT|pc|h9|pg||
pc|h5|pc|hQ|pc|c5|pc|hJ|pg||
pc|d8|pc|c9|pc|cA|pc|c2|pg||
pg||
qx|c5|st||md|3S765HQ63DKQ872C84,SK4HT742DJ6CJT953,SAJ83HJ98DT95CAKQ,SQT92HAK5DA43C762|sv|n|mb|1N|mb|p|mb|p|mb|p|pg||
pc|hA|pc|h3|pc|h2|pc|h8|pg||
pc|hK|pc|hQ|pc|h4|pc|h9|pg||
pc|h5|pc|h6|pc|h7|pc|hJ|pg||
pc|dT|pc|d3|pc|dQ|pc|d6|pg||
pc|s5|pc|s4|pc|s3|pc|s9|pg||
pc|s2|pc|s6|pc|sK|pc|sA|pg||
pc|d9|pc|d4|pc|dK|pc|dJ|pg||
pc|s7|pc|c5|pc|s8|pc|sT|pg||
pc|sQ|pc|d2|pc|c3|pc|sJ|pg||
pc|dA|pc|d7|pc|c9|pc|d5|pg||
mc|7|pg||
qx|o6|st||md|4SAK8HJ8754DQ9CJ76,SQJ7HAT3D542CAK85,ST32HK9DJT76CQ432,S9654HQ62DAK83CT9|sv|e|mb|p|mb|p|mb|1C|mb|p|mb|1S|mb|p|mb|1N|mb|p|mb|p|mb|p|pg||
pc|d6|pc|dA|pc|d9|pc|d2|pg||
pc|s4|pc|s8|pc|sJ|pc|s3|pg||
pc|sQ|pc|s2|pc|s5|pc|sK|pg||
pc|dQ|pc|d4|pc|d7|pc|d3|pg||
pc|c7|pc|cA|pc|c2|pc|c9|pg||
pc|s7|pc|sT|pc|s6|pc|sA|pg||
pc|cJ|pc|cK|pc|c3|pc|cT|pg||
pc|d5|pc|dT|pc|dK|pc|h8|pg||
pc|s9|pc|c6|pc|h3|pc|c4|pg||
pc|d8|pc|h4|pc|c5|pc|dJ|pg||
pc|cQ|pc|h2|pc|h5|pc|c8|pg||
pc|h9|pc|hQ|pc|h7|pc|hT|pg||
pc|h6|pc|hJ|pc|hA|pc|hK|pg||
pg||
qx|c6|st||md|4SAK8HJ8754DQ9CJ76,SQJ7HAT3D542CAK85,ST32HK9DJT76CQ432,S9654HQ62DAK83CT9|sv|e|mb|p|mb|1H|mb|d|mb|p|mb|1S|mb|p|mb|p|mb|d|mb|r|mb|1N|mb|p|mb|p|mb|d|mb|p|mb|p|mb|p|pg||
pc|sQ|pc|s2|pc|s6|pc|sA|pg||
pc|dQ|pc|d5|pc|d6|pc|dK|pg||
pc|cT|pc|c6|pc|c5|pc|cQ|pg||
pc|d7|pc|d3|pc|d9|pc|d4|pg||
pc|cJ|pc|cA|pc|c2|pc|c9|pg||
pc|cK|pc|c3|pc|d8|pc|c7|pg||
pc|c8|pc|c4|pc|s9|pc|h4|pg||
pc|h3|pc|h9|pc|hQ|pc|h5|pg||
pc|s5|pc|sK|pc|s7|pc|s3|pg||
pc|h7|pc|hA|pc|hK|pc|h2|pg||
pc|sJ|pc|sT|pc|s4|pc|s8|pg||
pc|d2|pc|dT|pc|dA|pc|h8|pg||
pc|h6|pc|hJ|pc|hT|pc|dJ|pg||
pg||
qx|o7|st||md|1S98HA863DJT8743C7,SA4HT42DA652CAQ64,SKJ73HK95DKQCK985,SQT652HQJ7D9CJT32|sv|b|mb|p|mb|1D|mb|d|mb|1S|mb|2H|mb|p|mb|p|mb|p|pg||
pc|sA|pc|s3|pc|s6|pc|s9|pg||
pc|s4|pc|sK|pc|s2|pc|s8|pg||
pc|dQ|pc|d9|pc|d4|pc|dA|pg||
pc|h2|pc|h5|pc|hJ|pc|h3|pg||
pc|sT|pc|c7|pc|h4|pc|s7|pg||
pc|hT|pc|h9|pc|h7|pc|hA|pg||
pc|h6|pc|c4|pc|hK|pc|hQ|pg||
pc|dK|mc|9|pg||
qx|c7|st||md|1S98HA863DJT8743C7,SA4HT42DA652CAQ64,SKJ73HK95DKQCK985,SQT652HQJ7D9CJT32|sv|b|mb|p|mb|1D|mb|d|mb|1S|mb|2H|mb|p|mb|p|mb|p|pg||
pc|sA|pc|s3|pc|s2|pc|s8|pg||
pc|s4|pc|sK|pc|s6|pc|s9|pg||
pc|dQ|pc|d9|pc|d4|pc|dA|pg||
pc|cA|pc|c5|pc|cJ|pc|c7|pg||
pc|c6|pc|cK|pc|c3|pc|d3|pg||
pc|hK|pc|h7|pc|h3|pc|h2|pg||
pc|h5|pc|hJ|pc|hA|pc|h4|pg||
pc|d7|pc|d6|pc|dK|pc|s5|pg||
pc|h9|pc|hQ|pc|h6|pc|hT|pg||
mc|9|pg||
qx|o8|st||md|2SAT964HKQ742DJ2C3,SQ873H95DKT95CK75,SJ52HAJ8DQ4CQJ942,SKHT63DA8763CAT86|sv|o|mb|p|mb|p|mb|1D|mb|2D|mb|3D|mb|4D|mb|5D|mb|p|mb|p|mb|p|pg||
pc|hK|pc|h5|pc|hA|pc|h3|pg||
pc|hJ|pc|h6|pc|h7|pc|h9|pg||
pc|s2|pc|sK|pc|sA|pc|s3|pg||
pc|c3|pc|c5|pc|cJ|pc|cA|pg||
pc|d3|pc|d2|pc|dK|pc|d4|pg||
pc|d5|pc|dQ|pc|dA|pc|dJ|pg||
mc|9|pg||
qx|c8|st||md|2SAT964HKQ742DJ2C3,SQ873H95DKT95CK75,SJ52HAJ8DQ4CQJ942,SKHT63DA8763CAT86|sv|o|mb|p|mb|p|mb|1D|mb|2D|mb|3D|mb|d|mb|p|mb|3H|mb|p|mb|p|mb|p|pg||
pc|h5|pc|hA|pc|h3|pc|h2|pg||
pc|s2|pc|sK|pc|sA|pc|s3|pg||
pc|h4|pc|h9|pc|hJ|pc|h6|pg||
pc|h8|pc|hT|pc|hQ|pc|d5|pg||
mc|9|pg||
qx|o9|st||md|3ST4H7D9543CAKT972,SJ983HKT652DJTCQ6,SQ52HQJ9843DK2C85,SAK76HADAQ876CJ43|sv|e|mb|2D|mb|p|mb|2H|mb|p|mb|p|mb|d|mb|p|mb|2S|mb|p|mb|3S|mb|p|mb|4S|mb|p|mb|p|mb|p|pg||
pc|hQ|pc|hA|pc|h7|pc|h2|pg||
pc|sA|pc|s4|pc|s3|pc|s2|pg||
pc|sK|pc|sT|pc|s8|pc|s5|pg||
pc|s6|pc|c2|pc|sJ|pc|sQ|pg||
pc|c8|pc|c3|pc|cK|pc|c6|pg||
pc|cA|pc|cQ|pc|c5|pc|c4|pg||
pc|c7|pc|s9|pc|h3|pc|cJ|pg||
pc|dJ|pc|dK|pc|dA|pc|d3|pg||
pc|d6|pc|d4|pc|dT|pc|d2|pg||
pc|hK|pc|h4|pc|d7|pc|c9|pg||
pc|h5|pc|h8|pc|s7|pc|cT|pg||
pc|dQ|pc|d5|pc|h6|pc|h9|pg||
pc|d8|pc|d9|pc|hT|pc|hJ|pg||
pg||
qx|c9|st||md|3ST4H7D9543CAKT972,SJ983HKT652DJTCQ6,SQ52HQJ9843DK2C85,SAK76HADAQ876CJ43|sv|e|mb|2H|mb|d|mb|p|mb|2S|mb|p|mb|3S|mb|p|mb|4S|mb|p|mb|p|mb|p|pg||
pc|hQ|pc|hA|pc|h7|pc|h2|pg||
pc|sA|pc|s4|pc|s3|pc|s2|pg||
pc|sK|pc|sT|pc|s8|pc|s5|pg||
pc|s6|pc|c2|pc|s9|pc|sQ|pg||
pc|c8|pc|c3|pc|cK|pc|c6|pg||
pc|cA|pc|cQ|pc|c5|pc|c4|pg||
pc|c7|pc|sJ|pc|h4|pc|cJ|pg||
pc|dJ|pc|dK|pc|dA|pc|d3|pg||
pc|d6|pc|d4|pc|dT|pc|d2|pg||
pc|hK|pc|h3|pc|d7|pc|c9|pg||
pc|h5|pc|h8|pc|s7|pc|cT|pg||
pc|dQ|pc|d5|pc|h6|pc|h9|pg||
pc|d8|pc|d9|pc|hT|pc|hJ|pg||
pg||
qx|o10|st||md|4S8HKQ9752D743C542,SA9732HATDKQT2C96,SQJT5H63DA8CQJT73,SK64HJ84DJ965CAK8|sv|b|mb|1D|mb|p|mb|1S|mb|p|mb|1N|mb|p|mb|2H|mb|p|mb|2S|mb|p|mb|3D|mb|p|mb|3S|mb|p|mb|4S|mb|d|mb|p|mb|p|mb|p|pg||
pc|cQ|pc|cA|pc|c5|pc|c6|pg||
pc|s4|pc|s8|pc|sA|pc|s5|pg||
pc|s2|pc|sT|pc|sK|pc|h2|pg||
pc|d5|pc|d7|pc|dK|pc|dA|pg||
pc|sJ|pc|s6|pc|h5|pc|s3|pg||
pc|h6|pc|h4|pc|hQ|pc|hA|pg||
pc|dQ|pc|d8|pc|d6|pc|d3|pg||
pc|d2|pc|c3|pc|dJ|pc|d4|pg||
pc|d9|pc|h7|pc|dT|pc|sQ|pg||
pc|cJ|pc|cK|pc|c2|pc|c9|pg||
pc|c8|pc|c4|pc|hT|pc|cT|pg||
mc|9|pg||
qx|c10|st||md|4S8HKQ9752D743C542,SA9732HATDKQT2C96,SQJT5H63DA8CQJT73,SK64HJ84DJ965CAK8|sv|b|mb|1D|mb|2H|mb|2S|mb|p|mb|3S|mb|p|mb|4S|mb|d|mb|p|mb|p|mb|p|pg||
pc|h6|pc|h4|pc|hQ|pc|hA|pg||
pc|sA|pc|s5|pc|s4|pc|s8|pg||
pc|s2|pc|sQ|pc|sK|pc|h5|pg||
pc|d5|pc|d7|pc|dK|pc|dA|pg||
pc|h3|pc|h8|pc|hK|pc|hT|pg||
mc|9|pg||
qx|o11|st||md|1SK5HAQ43DT854CJ65,SAQ7HKT65D632CAQ8,ST9864HJ8DAKQ7C74,SJ32H972DJ9CKT932|sv|o|mb|p|mb|1N|mb|p|mb|p|mb|p|pg||
pc|dQ|pc|d9|pc|d4|pc|d3|pg||
pc|sT|pc|sJ|pc|sK|pc|sA|pg||
pc|cA|pc|c4|pc|c2|pc|c6|pg||
pc|cQ|pc|c7|pc|c3|pc|c5|pg||
pc|c8|pc|s4|pc|cK|pc|cJ|pg||
pc|cT|pc|h3|pc|h5|pc|s6|pg||
pc|c9|pc|s5|pc|h6|pc|d7|pg||
pc|s2|pc|h4|pc|sQ|pc|s8|pg||
pc|s7|pc|s9|pc|s3|pc|d5|pg||
pc|dA|pc|dJ|pc|d8|pc|d2|pg||
pc|dK|pc|h2|pc|dT|pc|d6|pg||
pc|h8|pc|h7|pc|hA|pc|hT|pg||
pc|hQ|pc|hK|pc|hJ|pc|h9|pg||
pg||
qx|c11|st||md|1SK5HAQ43DT854CJ65,SAQ7HKT65D632CAQ8,ST9864HJ8DAKQ7C74,SJ32H972DJ9CKT932|sv|o|mb|p|mb|1N|mb|2S|mb|p|mb|p|mb|p|pg||
pc|cT|pc|c5|pc|c8|pc|c4|pg||
pc|c3|pc|c6|pc|cA|pc|c7|pg||
pc|cQ|pc|s4|pc|c2|pc|cJ|pg||
pc|s6|pc|s3|pc|sK|pc|sA|pg||
pc|d3|pc|dA|pc|d9|pc|d4|pg||
pc|s9|pc|s2|pc|s5|pc|sQ|pg||
pc|d6|pc|dK|pc|dJ|pc|d8|pg||
pc|sT|pc|sJ|pc|h3|pc|s7|pg||
pc|h9|pc|h4|pc|hK|pc|h8|pg||
mc|7|pg||
qx|o12|st||md|2SA9HQT9876DKJ65C4,SK63HK2DT8CJ98632,SQ8742HAJ53D7CAQ5,SJT5H4DAQ9432CKT7|sv|n|mb|p|mb|1S|mb|3D|mb|3H|mb|p|mb|4D|mb|p|mb|4H|mb|p|mb|p|mb|p|pg||
pc|dT|pc|d7|pc|dA|pc|d5|pg||
pc|h4|pc|hT|pc|hK|pc|hA|pg||
pc|h3|pc|d2|pc|hQ|pc|h2|pg||
pc|c4|pc|c2|pc|cQ|pc|cK|pg||
mc|11|pg||
qx|c12|st||md|2SA9HQT9876DKJ65C4,SK63HK2DT8CJ98632,SQ8742HAJ53D7CAQ5,SJT5H4DAQ9432CKT7|sv|n|mb|p|mb|1S|mb|2D|mb|2H|mb|p|mb|4H|mb|p|mb|p|mb|p|pg||
pc|dT|pc|d7|pc|dA|pc|d5|pg||
pc|sJ|pc|sA|pc|s3|pc|s2|pg||
pc|s9|pc|sK|pc|s4|pc|s5|pg||
pc|c8|pc|cA|pc|c7|pc|c4|pg||
pc|hA|pc|h4|pc|h6|pc|h2|pg||
mc|10|pg||
qx|o13|st||md|3SA7432HDKQT83CAQT,SKJHAKT9D7652CK87,SQ85HQJ542DA4C943,ST96H8763DJ9CJ652|sv|b|mb|p|mb|p|mb|1S|mb|d|mb|2C|mb|p|mb|2D|mb|p|mb|4S|mb|p|mb|p|mb|p|pg||
pc|hA|pc|h2|pc|h3|pc|s3|pg||
pc|s2|pc|sK|pc|s5|pc|s6|pg||
pc|sJ|pc|sQ|pc|s9|pc|s4|pg||
pc|c3|pc|c2|pc|cT|pc|cK|pg||
pc|c8|pc|c4|pc|c5|pc|cQ|pg||
pc|d3|pc|d2|pc|dA|pc|d9|pg||
pc|d4|pc|dJ|pc|dK|pc|d5|pg||
pc|sA|mc|11|pg||
qx|c13|st||md|3SA7432HDKQT83CAQT,SKJHAKT9D7652CK87,SQ85HQJ542DA4C943,ST96H8763DJ9CJ652|sv|b|mb|p|mb|p|mb|1S|mb|d|mb|2H!|mb|p|mb|4S|mb|p|mb|p|mb|p|pg||
pc|hA|pc|h2|pc|h8|pc|s2|pg||
pc|s3|pc|sK|pc|s5|pc|s6|pg||
pc|sJ|pc|sQ|pc|s9|pc|s4|pg||
pc|c3|pc|c2|pc|cT|pc|cK|pg||
pc|d7|pc|d4|pc|dJ|pc|dK|pg||
pc|sA|mc|11|pg||
qx|o14|st||md|4SKT7H9865DQJCJ865,S862HTDT953CAK973,SQ5HJ732DAK8762CQ,SAJ943HAKQ4D4CT42|sv|o|mb|1S|mb|p|mb|2S|mb|3D|mb|3S|mb|p|mb|4S|mb|p|mb|p|mb|p|pg||
pc|dQ|pc|d3|pc|d2|pc|d4|pg||
pc|dJ|pc|d5|pc|d6|pc|s3|pg||
pc|hA|pc|h5|pc|hT|pc|h2|pg||
pc|h4|pc|h6|pc|s2|pc|h3|pg||
pc|s6|pc|s5|pc|s9|pc|sT|pg||
pc|c8|pc|cA|pc|cQ|pc|c2|pg||
pc|s8|pc|sQ|pc|sA|pc|s7|pg||
pc|hK|pc|h8|pc|c3|pc|h7|pg||
pc|hQ|pc|h9|pc|c7|pc|hJ|pg||
pc|c4|pc|c6|pc|c9|pc|d7|pg||
mc|10|pg||
qx|c14|st||md|4SKT7H9865DQJCJ865,S862HTDT953CAK973,SQ5HJ732DAK8762CQ,SAJ943HAKQ4D4CT42|sv|o|mb|1S|mb|p|mb|2S|mb|3D|mb|3H|mb|p|mb|4S|mb|p|mb|p|mb|p|pg||
pc|dQ|pc|d3|pc|d2|pc|d4|pg||
pc|dJ|pc|d5|pc|d6|pc|s3|pg||
pc|hA|pc|h5|pc|hT|pc|h2|pg||
pc|h4|pc|h6|pc|s6|pc|h3|pg||
pc|s8|pc|s5|pc|s4|pc|sT|pg||
pc|c5|pc|c3|pc|cQ|pc|c2|pg||
pc|dK|pc|s9|pc|sK|pc|d9|pg||
pc|c6|pc|cA|pc|d7|pc|c4|pg||
pc|s2|pc|sQ|pc|sA|pc|s7|pg||
mc|9|pg||
qx|o15|st||md|1S97HT94DJ9852CK95,SAJ865HQDA3CAQT62,ST43HAJ76DKQ76C73,SKQ2HK8532DT4CJ84|sv|n|mb|p|mb|1S|mb|p|mb|2S|mb|p|mb|4S|mb|p|mb|p|mb|p|pg||
pc|c7|pc|cJ|pc|cK|pc|cA|pg||
pc|sA|pc|s4|pc|s2|pc|s7|pg||
pc|s5|pc|s3|pc|sK|pc|s9|pg||
pc|h2|pc|hT|pc|hQ|pc|hA|pg||
pc|sT|pc|sQ|pc|d2|pc|s6|pg||
pc|hK|pc|h4|pc|d3|pc|h6|pg||
pc|c8|pc|c9|pc|cQ|pc|c3|pg||
mc|12|pg||
qx|c15|st||md|1S97HT94DJ9852CK95,SAJ865HQDA3CAQT62,ST43HAJ76DKQ76C73,SKQ2HK8532DT4CJ84|sv|n|mb|p|mb|1S|mb|p|mb|1N|mb|p|mb|2C|mb|p|mb|3S|mb|p|mb|4S|mb|p|mb|p|mb|p|pg||
pc|dK|pc|d4|pc|d2|pc|dA|pg||
pc|s5|pc|s4|pc|sK|pc|s7|pg||
pc|s2|pc|s9|pc|sJ|pc|s3|pg||
pc|s6|pc|sT|pc|sQ|pc|d5|pg||
pc|cJ|pc|cK|pc|cA|pc|c3|pg||
pc|cQ|pc|c7|pc|c4|pc|c5|pg||
pc|cT|pc|h6|pc|c8|pc|c9|pg||
pc|c6|pc|h7|pc|h2|pc|h4|pg||
pc|hQ|pc|hA|pc|h3|pc|h9|pg||
pc|dQ|pc|dT|pc|d8|pc|d3|pg||
mc|11|pg||
qx|o16|st||md|2SJ98642HQ6DJT976C,SAT73HTDAKCA98653,S5HAK853DQ82CKQ42,SKQHJ9742D543CJT7|sv|e|mb|1C|mb|1H|mb|1N|mb|p|mb|3C|mb|p|mb|p|mb|p|pg||
pc|hA|pc|h2|pc|h6|pc|hT|pg||
pc|h3|pc|h4|pc|hQ|pc|c3|pg||
pc|cA|pc|c2|pc|c7|pc|s2|pg||
pc|s3|pc|s5|pc|sQ|pc|s4|pg||
pc|sK|pc|s6|pc|s7|pc|c4|pg||
pc|cQ|pc|cT|pc|d6|pc|c5|pg||
pc|cK|pc|cJ|pc|s8|pc|c6|pg||
pc|hK|pc|h7|pc|d7|pc|c8|pg||
pc|dK|pc|d2|pc|d3|pc|d9|pg||
pc|dA|pc|d8|pc|d4|pc|dT|pg||
pc|sA|pc|h5|pc|h9|pc|s9|pg||
pc|sT|pc|h8|pc|hJ|pc|sJ|pg||
pc|dJ|pc|c9|pc|dQ|pc|d5|pg||
pg||
qx|c16|st||md|2SJ98642HQ6DJT976C,SAT73HTDAKCA98653,S5HAK853DQ82CKQ42,SKQHJ9742D543CJT7|sv|e|mb|1C|mb|1H|mb|1N|mb|p|mb|3N|mb|p|mb|p|mb|p|pg||
pc|s2|pc|s7|pc|s5|pc|sQ|pg||
pc|cJ|pc|s9|pc|c3|pc|cQ|pg||
pc|h5|pc|h2|pc|hQ|pc|hT|pg||
pc|h6|pc|s3|pc|hK|pc|h4|pg||
pc|d8|pc|d3|pc|dJ|pc|dK|pg||
pc|sT|pc|h3|pc|sK|pc|s4|pg||
pc|cT|pc|s6|pc|c5|pc|cK|pg||
pc|hA|pc|h7|pc|d6|pc|c6|pg||
mc|8|pg||