vg|41st WBTC-BBO3,VC-SF2,I,17,32,NETHERLANDS,25,USA2,25|
rs|3NN+2,3NN+2,4SE-1,4SE-2,4SWx-1,4SW=,2SS=,2SS+1,1NN-3,1NN-3,3NW-1,3NW-1,3NS+1,3NS+2,1NE+2,3NE=,2SE=,2NW-1,2HW+1,2NS-2,6HS-1,6NN-1,3NN+1,4SN+1,3NE=,3NE-1,2CS=,1NE-2,3NN-3,1NS+3,3NE-1,3NE-1|
pn|MICHIELSEN,EYTHORSDOT,WORTEL,SEAMON-MOL,MEYERS,VAN ZWOL,ZUR-CAMPAN,ARNOLDS|pg||
qx|o17|st||md|3SA953HQJ63DKJC542,SJT8764HA987D6CQ3,SQ2HKT4DQ43CAKJ76,SKH52DAT98752CT98|sv|o|mb|1N|mb|3D|mb|3N|mb|p|mb|p|mb|p|pg||
pc|d9|pc|dJ|pc|d6|pc|d4|pg||
pc|h3|pc|h7|pc|hT|pc|h5|pg||
pc|hK|pc|h2|pc|h6|pc|h8|pg||
pc|h4|pc|cT|pc|hJ|pc|hA|pg||
pc|sJ|pc|sQ|pc|sK|pc|sA|pg||
pc|hQ|pc|h9|pc|s2|pc|d2|pg||
pc|c5|pc|c3|pc|cJ|pc|c8|pg||
pc|cA|pc|c9|pc|c2|pc|cQ|pg||
pc|cK|pc|d5|pc|c4|pc|s4|pg||
mc|11|pg||
qx|c17|st||md|3SA953HQJ63DKJC542,SJT8764HA987D6CQ3,SQ2HKT4DQ43CAKJ76,SKH52DAT98752CT98|sv|o|mb|1N|mb|3D|mb|d|mb|p|mb|3N|mb|p|mb|p|mb|p|pg||
pc|dT|pc|dK|pc|d6|pc|d3|pg||
pc|h3|pc|h7|pc|hK|pc|h2|pg||
pc|hT|pc|h5|pc|h6|pc|h8|pg||
pc|h4|pc|d7|pc|hJ|pc|hA|pg||
pc|c3|pc|cJ|pc|c8|pc|c2|pg||
pc|d4|pc|dA|pc|dJ|pc|sJ|pg||
pc|c9|pc|c4|pc|cQ|pc|cA|pg||
mc|11|pg||
qx|o18|st||md|4SAK73HJT74D9CKJ94,ST642HQ52DAQT5CA6,SHK96D86432C87532,SQJ985HA83DKJ7CQT|sv|n|mb|1S|mb|p|mb|3C|mb|p|mb|3S|mb|p|mb|4S|mb|p|mb|p|mb|p|pg||
pc|d9|pc|dQ|pc|d6|pc|d7|pg||
pc|sT|pc|c8|pc|s5|pc|s3|pg||
pc|s2|pc|d4|pc|sQ|pc|sA|pg||
pc|sK|pc|s4|pc|d3|pc|s8|pg||
pc|s7|pc|s6|pc|d2|pc|sJ|pg||
mc|9|pg||
qx|c18|st||md|4SAK73HJT74D9CKJ94,ST642HQ52DAQT5CA6,SHK96D86432C87532,SQJ985HA83DKJ7CQT|sv|n|mb|1S|mb|p|mb|2N|mb|p|mb|3S|mb|p|mb|4S|mb|p|mb|p|mb|p|pg||
pc|hJ|pc|hQ|pc|hK|pc|hA|pg||
pc|s5|pc|s3|pc|sT|pc|c8|pg||
pc|s2|pc|d6|pc|sQ|pc|sK|pg||
pc|hT|pc|h2|pc|h6|pc|h3|pg||
pc|h4|pc|h5|pc|h9|pc|h8|pg||
pc|c3|pc|cT|pc|cJ|pc|cA|pg||
pc|s4|pc|c2|pc|s8|pc|sA|pg||
pc|cK|pc|c6|pc|c5|pc|cQ|pg||
mc|8|pg||
qx|o19|st||md|1SAQ5HQJ63DT7CQ874,SKJT864HT954D3CKJ,S3HAK72DA962C6532,S972H8DKQJ854CAT9|sv|e|mb|1C|mb|1S|mb|d|mb|2C|mb|2H|mb|2S|mb|4H|mb|4S|mb|p|mb|p|mb|d|mb|p|mb|p|mb|p|pg||
pc|hA|pc|h8|pc|h3|pc|h5|pg||
pc|h2|pc|s2|pc|h6|pc|h4|pg||
pc|dK|pc|d7|pc|d3|pc|dA|pg||
pc|c6|pc|c9|pc|cQ|pc|cK|pg||
pc|h9|pc|h7|pc|s7|pc|hJ|pg||
pc|dQ|pc|dT|pc|hT|pc|d2|pg||
pc|s9|pc|s5|pc|sK|pc|s3|pg||
mc|9|pg||
qx|c19|st||md|1SAQ5HQJ63DT7CQ874,SKJT864HT954D3CKJ,S3HAK72DA962C6532,S972H8DKQJ854CAT9|sv|e|mb|p|mb|2D|mb|p|mb|2H|mb|p|mb|2S|mb|d|mb|4S|mb|p|mb|p|mb|p|pg||
pc|hA|pc|h8|pc|h3|pc|h4|pg||
pc|c3|pc|c9|pc|cQ|pc|cK|pg||
pc|h5|pc|h2|pc|s2|pc|h6|pg||
pc|cA|pc|c4|pc|cJ|pc|c2|pg||
pc|cT|pc|c7|pc|d3|pc|c5|pg||
pc|dK|pc|d7|pc|s4|pc|d2|pg||
pc|h9|pc|h7|pc|s7|pc|hJ|pg||
pc|d4|pc|dT|pc|s6|pc|d6|pg||
pc|hT|pc|hK|pc|s9|pc|hQ|pg||
pc|d5|pc|c8|pc|s8|pc|d9|pg||
mc|10|pg||
qx|o20|st||md|2ST7HQT75DAK94CAQ2,SAK5H643D8753C964,SQ6432HJ92D62CKT8,SJ98HAK8DQJTCJ753|sv|b|mb|p|mb|p|mb|1C|mb|1N|mb|p|mb|2H|mb|p|mb|2S|mb|p|mb|p|mb|p|pg||
pc|c4|pc|cK|pc|c7|pc|c2|pg||
pc|s2|pc|s9|pc|sT|pc|sA|pg||
pc|h3|pc|h2|pc|hK|pc|h5|pg||
pc|c5|pc|cA|pc|c6|pc|c8|pg||
pc|s7|pc|s5|pc|s3|pc|s8|pg||
pc|c3|pc|cQ|pc|c9|pc|cT|pg||
pc|dA|pc|d3|pc|d2|pc|dT|pg||
pc|dK|pc|d5|pc|d6|pc|dJ|pg||
pc|d4|pc|d7|pc|s4|pc|dQ|pg||
pc|s6|pc|sJ|pc|h7|pc|sK|pg||
pc|d8|pc|h9|pc|h8|pc|d9|pg||
mc|8|pg||
qx|c20|st||md|2ST7HQT75DAK94CAQ2,SAK5H643D8753C964,SQ6432HJ92D62CKT8,SJ98HAK8DQJTCJ753|sv|b|mb|p|mb|p|mb|1C|mb|1N|mb|p|mb|2H|mb|p|mb|2S|mb|p|mb|p|mb|p|pg||
pc|sA|pc|s2|pc|s8|pc|s7|pg||
pc|sK|pc|s3|pc|s9|pc|sT|pg||
pc|s5|pc|sQ|pc|sJ|pc|d4|pg||
mc|9|pg||
qx|o21|st||md|3S873H9752D98CJT74,SJ64H4DK7652CK953,SA952HAJ83DQJCA86,SKQTHKQT6DAT43CQ2|sv|n|mb|1N|mb|p|mb|p|mb|p|pg||
pc|hQ|pc|h2|pc|h4|pc|h3|pg||
pc|h6|pc|h9|pc|d5|pc|h8|pg||
pc|cJ|pc|c3|pc|c8|pc|cQ|pg||
pc|sK|pc|s3|pc|s6|pc|s2|pg||
pc|d3|pc|d8|pc|dK|pc|dQ|pg||
pc|d2|pc|dJ|pc|dA|pc|d9|pg||
pc|dT|pc|h5|pc|d6|pc|s5|pg||
pc|d4|pc|s7|pc|d7|pc|hJ|pg||
pc|s4|pc|sA|pc|sT|pc|s8|pg||
pc|hA|pc|hT|pc|h7|pc|c5|pg||
pc|cA|pc|c2|pc|c4|pc|c9|pg||
pc|c6|pc|hK|pc|c7|pc|cK|pg||
pc|sJ|pc|s9|pc|sQ|pc|cT|pg||
pg||
qx|c21|st||md|3S873H9752D98CJT74,SJ64H4DK7652CK953,SA952HAJ83DQJCA86,SKQTHKQT6DAT43CQ2|sv|n|mb|1N|mb|p|mb|p|mb|p|pg||
pc|hK|pc|h2|pc|h4|pc|h8|pg||
pc|d3|pc|d8|pc|dK|pc|dJ|pg||
pc|d5|pc|dQ|pc|dA|pc|d9|pg||
pc|dT|pc|h5|pc|d2|pc|s2|pg||
pc|d4|pc|c4|pc|d6|pc|s5|pg||
pc|d7|pc|h3|pc|h6|pc|s3|pg||
pc|s6|pc|sA|pc|sT|pc|s7|pg||
pc|s9|pc|sQ|pc|s8|pc|s4|pg||
pc|sK|pc|h7|pc|sJ|pc|c6|pg||
pc|cQ|pc|c7|pc|c3|pc|cA|pg||
pc|c8|pc|c2|pc|cT|pc|cK|pg||
mc|4|pg||
qx|o22|st||md|4SQJ2HT543DKQ85CT7,S73HAK6DA64CAQJ65,SA964HJ72DT973CK8,SKT85HQ98DJ2C9432|sv|e|mb|p|mb|p|mb|1C|mb|p|mb|1S|mb|p|mb|2N|mb|p|mb|3N|mb|p|mb|p|mb|p|pg||
pc|dT|pc|dJ|pc|dQ|pc|d4|pg||
pc|d5|pc|d6|pc|d7|pc|d2|pg||
pc|d9|pc|c2|pc|dK|pc|dA|pg||
pc|h6|pc|h2|pc|hQ|pc|h3|pg||
pc|c3|pc|c7|pc|cJ|pc|cK|pg||
pc|d3|pc|h8|pc|d8|pc|s3|pg||
pc|h5|pc|hK|pc|h7|pc|h9|pg||
pc|cA|pc|c8|pc|c4|pc|cT|pg||
pc|cQ|mc|8|pg||
qx|c22|st||md|4SQJ2HT543DKQ85CT7,S73HAK6DA64CAQJ65,SA964HJ72DT973CK8,SKT85HQ98DJ2C9432|sv|e|mb|p|mb|p|mb|1C|mb|p|mb|1S|mb|p|mb|2N|mb|p|mb|3N|mb|p|mb|p|mb|p|pg||
pc|dT|pc|d2|pc|d5|pc|d6|pg||
pc|d7|pc|dJ|pc|dQ|pc|d4|pg||
pc|dK|pc|dA|pc|d3|pc|s5|pg||
pc|h6|pc|h2|pc|hQ|pc|h3|pg||
pc|c2|pc|c7|pc|cQ|pc|cK|pg||
pc|d9|pc|c3|pc|d8|pc|s3|pg||
pc|sA|mc|8|pg||
qx|o23|st||md|1SKT64HAT63DAKC875,S532H95D873CAQT43,SA9HQ42DQJ952CKJ9,SQJ87HKJ87DT64C62|sv|b|mb|1N|mb|p|mb|3C|mb|p|mb|3D|mb|p|mb|3N|mb|p|mb|p|mb|p|pg||
pc|c4|pc|cJ|pc|c6|pc|c7|pg||
pc|d2|pc|d6|pc|dK|pc|d8|pg||
pc|dA|pc|d3|pc|d5|pc|dT|pg||
pc|s4|pc|s5|pc|sA|pc|s7|pg||
pc|dQ|pc|d4|pc|h3|pc|d7|pg||
pc|dJ|pc|c2|pc|c5|pc|c3|pg||
pc|d9|pc|h7|pc|h6|pc|cT|pg||
pc|s9|pc|sQ|pc|sK|pc|s2|pg||
pc|c8|pc|cA|pc|c9|pc|h8|pg||
pc|h5|pc|h2|pc|hJ|pc|hA|pg||
pc|hT|pc|h9|pc|h4|pc|hK|pg||
pc|sJ|pc|s6|pc|s3|pc|cK|pg||
pc|s8|pc|sT|pc|cQ|pc|hQ|pg||
pg||
qx|c23|st||md|1SKT64HAT63DAKC875,S532H95D873CAQT43,SA9HQ42DQJ952CKJ9,SQJ87HKJ87DT64C62|sv|b|mb|1C|mb|p|mb|1D|mb|p|mb|1N|mb|p|mb|3N|mb|p|mb|p|mb|p|pg||
pc|c3|pc|cJ|pc|c2|pc|c5|pg||
pc|d2|pc|d4|pc|dK|pc|d3|pg||
pc|dA|pc|d7|pc|d5|pc|d6|pg||
pc|c7|pc|cA|pc|c9|pc|c6|pg||
pc|cT|pc|cK|pc|dT|pc|c8|pg||
pc|dQ|pc|h7|pc|h3|pc|d8|pg||
pc|dJ|pc|h8|pc|h6|pc|s2|pg||
pc|d9|pc|s7|pc|hT|pc|h5|pg||
pc|sA|pc|s8|pc|s4|pc|s3|pg||
pc|s9|pc|sJ|pc|sK|pc|s5|pg||
pc|s6|pc|c4|pc|h2|pc|sQ|pg||
mc|11|pg||
qx|o24|st||md|2S94HK8743DKQJ4C83,S5HA92DT732CKT542,SKT872HQ65DA8C976,SAQJ63HJTD965CAQJ|sv|o|mb|p|mb|p|mb|1N|mb|p|mb|p|mb|p|pg||
pc|dK|pc|d2|pc|d8|pc|d5|pg||
pc|h3|pc|h2|pc|hQ|pc|hT|pg||
pc|dA|pc|d6|pc|d4|pc|d3|pg||
pc|s7|pc|sQ|pc|s4|pc|s5|pg||
pc|hJ|pc|h4|pc|h9|pc|h5|pg||
pc|cA|pc|c3|pc|c2|pc|c6|pg||
pc|cQ|pc|c8|pc|c4|pc|c7|pg||
pc|sA|pc|s9|pc|d7|mc|9|pg||
qx|c24|st||md|2S94HK8743DKQJ4C83,S5HA92DT732CKT542,SKT872HQ65DA8C976,SAQJ63HJTD965CAQJ|sv|o|mb|p|mb|p|mb|1N|mb|p|mb|2N|mb|p|mb|3N|mb|p|mb|p|mb|p|pg||
pc|dJ|pc|d2|pc|d8|pc|d6|pg||
pc|d4|pc|d3|pc|dA|pc|d5|pg||
pc|s7|pc|sQ|pc|s9|pc|s5|pg||
pc|hJ|pc|h3|pc|h2|pc|hQ|pg||
pc|h5|pc|hT|pc|h4|pc|h9|pg||
pc|sA|pc|s4|pc|d7|pc|s2|pg||
mc|9|pg||
qx|o25|st||md|3S93HJT4DK9842C654,SAT42HQ9876DQCAJT,SKQ75HK532DJ3CKQ2,SJ86HADAT765C9873|sv|e|mb|1N|mb|p|mb|p|mb|d|mb|p|mb|2C|mb|p|mb|2H|mb|p|mb|2S|mb|p|mb|p|mb|p|pg||
pc|s9|pc|s2|pc|sQ|pc|s6|pg||
pc|d3|pc|dA|pc|d4|pc|dQ|pg||
pc|d5|pc|d2|pc|s4|pc|dJ|pg||
pc|h6|pc|h2|pc|hA|pc|h4|pg||
pc|d6|pc|d8|pc|sA|pc|h3|pg||
pc|h7|pc|h5|pc|s8|pc|hT|pg||
pc|d7|pc|d9|pc|sT|pc|sK|pg||
pc|hK|pc|dT|pc|hJ|pc|h9|pg||
pc|cQ|pc|c3|pc|c4|pc|cA|pg||
pc|cT|pc|cK|pc|c7|pc|c5|pg||
pc|s5|pc|sJ|pc|s3|pc|cJ|pg||
pc|c8|pc|c6|pc|h8|pc|c2|pg||
pc|c9|pc|dK|pc|hQ|pc|s7|pg||
pg||
qx|c25|st||md|3S93HJT4DK9842C654,SAT42HQ9876DQCAJT,SKQ75HK532DJ3CKQ2,SJ86HADAT765C9873|sv|e|mb|1C|mb|1D|mb|p|mb|1H|mb|p|mb|2D|mb|p|mb|2N|mb|p|mb|p|mb|p|pg||
pc|s5|pc|s8|pc|s9|pc|sT|pg||
pc|dQ|pc|d3|pc|d5|pc|dK|pg||
pc|s3|pc|s2|pc|sQ|pc|s6|pg||
pc|h5|pc|hA|pc|h4|pc|h6|pg||
pc|c3|pc|c6|pc|cT|pc|cQ|pg||
pc|dJ|pc|dA|pc|d2|pc|h8|pg||
pc|dT|pc|d4|pc|h7|pc|h2|pg||
pc|sJ|pc|c5|pc|sA|pc|s7|pg||
pc|s4|pc|sK|pc|d6|pc|c4|pg||
pc|hK|pc|c7|pc|hT|pc|h9|pg||
pc|h3|pc|d7|pc|hJ|pc|hQ|pg||
pc|cA|pc|c2|pc|c8|pc|d8|pg||
pc|cJ|pc|cK|pc|c9|pc|d9|pg||
pg||
qx|o26|st||md|4SK8H432DK865CJT63,SAT74HAKT7DT7CQ97,SQJ953HQ5DAQ9CK82,S62HJ986DJ432CA54|sv|b|mb|p|mb|p|mb|1C|mb|1S|mb|d|mb|p|mb|2H|mb|p|mb|p|mb|p|pg||
pc|sQ|pc|s2|pc|s8|pc|s4|pg||
pc|s5|pc|s6|pc|sK|pc|sA|pg||
pc|dT|pc|dQ|pc|d2|pc|d5|pg||
pc|sJ|pc|h6|pc|h3|pc|s7|pg||
pc|h8|pc|h4|pc|hA|pc|h5|pg||
pc|hK|pc|hQ|pc|h9|pc|h2|pg||
pc|sT|pc|s3|pc|c4|pc|d6|pg||
mc|9|pg||
qx|c26|st||md|4SK8H432DK865CJT63,SAT74HAKT7DT7CQ97,SQJ953HQ5DAQ9CK82,S62HJ986DJ432CA54|sv|b|mb|p|mb|p|mb|1C|mb|1S|mb|p|mb|1N|mb|p|mb|2N|mb|p|mb|p|mb|p|pg||
pc|hA|pc|h5|pc|h6|pc|h2|pg||
pc|h7|pc|hQ|pc|h8|pc|h3|pg||
pc|s3|pc|s2|pc|sK|pc|sA|pg||
pc|d7|pc|dQ|pc|d2|pc|d5|pg||
pc|sQ|pc|s6|pc|s8|pc|s4|pg||
pc|sJ|pc|c5|pc|c3|pc|s7|pg||
pc|dA|pc|d3|pc|d6|pc|dT|pg||
pc|d9|pc|d4|pc|dK|pc|c9|pg||
pc|cJ|pc|cQ|pc|cK|pc|cA|pg||
pc|dJ|pc|d8|pc|c7|pc|c2|pg||
pc|h9|pc|h4|mc|6|pg||
qx|o27|st||md|1S95HAJ8643DK5CKQ9,S864H95DQ976C8652,SK2HKQT2DAJT43CA4,SAQJT73H7D82CJT73|sv|o|mb|1H|mb|p|mb|2D|mb|2S|mb|p|mb|p|mb|3H|mb|p|mb|3N|mb|p|mb|4C|mb|p|mb|4N|mb|p|mb|5D|mb|p|mb|6H|mb|p|mb|p|mb|p|pg||
pc|s4|pc|sK|pc|sA|pc|s5|pg||
pc|sQ|pc|s9|pc|s6|pc|s2|pg||
mc|11|pg||
qx|c27|st||md|1S95HAJ8643DK5CKQ9,S864H95DQ976C8652,SK2HKQT2DAJT43CA4,SAQJT73H7D82CJT73|sv|o|mb|1H|mb|p|mb|2N|mb|3S|mb|p|mb|p|mb|4C|mb|p|mb|4D|mb|p|mb|4N|mb|p|mb|5D|mb|p|mb|6N|mb|p|mb|p|mb|p|pg||
pc|h7|pc|h3|pc|h5|pc|hK|pg||
pc|hQ|pc|s7|pc|h4|pc|h9|pg||
pc|hT|pc|s3|pc|h6|pc|s8|pg||
pc|h2|pc|sT|pc|hA|pc|s6|pg||
pc|hJ|pc|c2|pc|d3|pc|sJ|pg||
pc|h8|pc|d6|pc|dJ|pc|d2|pg||
pc|c9|pc|c5|pc|cA|pc|c3|pg||
pc|c4|pc|c7|pc|cQ|pc|c6|pg||
pc|cK|pc|c8|pc|s2|pc|cT|pg||
pc|dK|pc|d7|pc|d4|pc|d8|pg||
pc|d5|pc|d9|pc|dA|pc|cJ|pg||
mc|11|pg||
qx|o28|st||md|2SKJT75HKQ7DJ4CT75,S963HJ643DQT9CJ96,SAQ2HT98DK52CAKQ3,S84HA52DA8763C842|sv|n|mb|p|mb|1C|mb|p|mb|1H|mb|p|mb|1N|mb|p|mb|2C|mb|p|mb|2D|mb|p|mb|3N|mb|p|mb|p|mb|p|pg||
pc|d6|pc|dJ|pc|dQ|pc|dK|pg||
pc|sA|pc|s8|pc|s5|pc|s9|pg||
pc|sQ|pc|s4|pc|s7|pc|s6|pg||
pc|s2|pc|h2|pc|sK|pc|s3|pg||
pc|sJ|pc|h6|pc|d2|pc|h5|pg||
pc|sT|pc|h3|pc|d5|pc|c4|pg||
pc|c5|mc|10|pg||
qx|c28|st||md|2SKJT75HKQ7DJ4CT75,S963HJ643DQT9CJ96,SAQ2HT98DK52CAKQ3,S84HA52DA8763C842|sv|n|mb|p|mb|1N|mb|p|mb|2H|mb|p|mb|2S|mb|p|mb|3N|mb|p|mb|4S|mb|p|mb|p|mb|p|pg||
pc|c2|pc|c5|pc|c9|pc|cA|pg||
pc|sA|pc|s4|pc|s5|pc|s6|pg||
pc|s2|pc|s8|pc|sK|pc|s3|pg||
pc|s7|pc|s9|pc|sQ|pc|d3|pg||
pc|hT|pc|h5|pc|hK|pc|h3|pg||
pc|c7|pc|c6|pc|cK|pc|c4|pg||
pc|cQ|pc|c8|pc|cT|pc|cJ|pg||
pc|c3|pc|d6|pc|d4|pc|dT|pg||
pc|h8|pc|h2|pc|hQ|pc|h4|pg||
mc|11|pg||
qx|o29|st||md|3SA84HQJ983D4CQ832,SQ752HA754DQJCKJ9,SKT3HT6DKT985C754,SJ96HK2DA7632CAT6|sv|b|mb|p|mb|1D|mb|1H|mb|d|mb|p|mb|1N|mb|p|mb|3N|mb|p|mb|p|mb|p|pg||
pc|hQ|pc|h4|pc|h6|pc|h2|pg||
pc|c2|pc|cJ|pc|c7|pc|c6|pg||
pc|s2|pc|s3|pc|s9|pc|s4|pg||
pc|s6|pc|s8|pc|s5|pc|sT|pg||
pc|c5|pc|cA|pc|c3|pc|c9|pg||
pc|hK|pc|h3|pc|h5|pc|hT|pg||
pc|sJ|pc|sA|pc|s7|pc|sK|pg||
pc|h8|pc|hA|pc|d5|pc|d2|pg||
pc|sQ|pc|d8|pc|d3|pc|d4|pg||
pc|cK|pc|c4|pc|cT|pc|c8|pg||
pc|dJ|pc|d9|pc|d6|pc|h9|pg||
pc|dQ|pc|dK|pc|dA|pc|cQ|pg||
pc|d7|pc|hJ|pc|h7|pc|dT|pg||
pg||
qx|c29|st||md|3SA84HQJ983D4CQ832,SQ752HA754DQJCKJ9,SKT3HT6DKT985C754,SJ96HK2DA7632CAT6|sv|b|mb|p|mb|1D|mb|1H|mb|d|mb|p|mb|1S|mb|p|mb|2H|mb|p|mb|2N|mb|p|mb|3N|mb|p|mb|p|mb|p|pg||
pc|hJ|pc|h4|pc|h6|pc|h2|pg||
pc|c2|pc|c9|pc|c7|pc|c6|pg||
pc|dQ|pc|dK|pc|d2|pc|d4|pg||
pc|hT|pc|hK|pc|h3|pc|h5|pg||
pc|d3|pc|h8|pc|dJ|pc|d5|pg||
pc|s2|pc|s3|pc|s9|pc|sA|pg||
pc|c3|pc|cJ|pc|c5|pc|cA|pg||
pc|s6|pc|s4|pc|sQ|pc|sK|pg||
pc|c4|pc|cT|pc|c8|pc|cK|pg||
pc|hA|pc|d8|pc|d6|pc|h9|pg||
pc|s5|pc|sT|pc|sJ|pc|s8|pg||
pc|dA|pc|cQ|pc|h7|pc|d9|pg||
pc|d7|pc|hQ|pc|s7|pc|dT|pg||
pg||
qx|o30|st||md|4S6543HT82DJ42CAK9,SKT87HAQDQT6CT653,SAQHJ743DA97CQJ74,SJ92HK965DK853C82|sv|o|mb|p|mb|p|mb|1C|mb|p|mb|1H|mb|p|mb|1S|mb|1N|mb|p|mb|2C|mb|p|mb|p|mb|p|pg||
pc|c3|pc|c4|pc|c2|pc|c9|pg||
pc|s3|pc|s7|pc|sQ|pc|s2|pg||
pc|h3|pc|h5|pc|h8|pc|hQ|pg||
pc|c5|pc|c7|pc|c8|pc|cA|pg||
pc|h2|pc|hA|pc|h4|pc|h6|pg||
pc|c6|pc|cJ|pc|d3|pc|cK|pg||
pc|s4|pc|s8|pc|sA|pc|s9|pg||
pc|cQ|pc|d5|pc|s5|pc|cT|pg||
pc|h7|pc|h9|pc|hT|pc|d6|pg||
mc|8|pg||
qx|c30|st||md|4S6543HT82DJ42CAK9,SKT87HAQDQT6CT653,SAQHJ743DA97CQJ74,SJ92HK965DK853C82|sv|o|mb|p|mb|p|mb|1C|mb|p|mb|1H|mb|p|mb|1S|mb|p|mb|1N|mb|p|mb|p|mb|p|pg||
pc|cA|pc|c3|pc|c4|pc|c2|pg||
pc|h8|pc|hA|pc|h3|pc|h5|pg||
pc|s7|pc|sQ|pc|s2|pc|s3|pg||
pc|c7|pc|c8|pc|cK|pc|c5|pg||
pc|c9|pc|c6|pc|cJ|pc|d3|pg||
pc|cQ|pc|h6|pc|s4|pc|cT|pg||
pc|h4|pc|h9|pc|h2|pc|hQ|pg||
pc|s8|pc|sA|pc|sJ|pc|s5|pg||
pc|h7|pc|hK|pc|hT|pc|d6|pg||
pc|s9|pc|s6|pc|sK|pc|d7|pg||
pc|sT|pc|d9|pc|d5|pc|d2|pg||
mc|5|pg||
qx|o31|st||md|1S876HA6DQ962CK875,SJ432H9742D7CAQ96,SATHKQT5DAT853CJ4,SKQ95HJ83DKJ4CT32|sv|n|mb|p|mb|p|mb|1N|mb|p|mb|3N|mb|p|mb|p|mb|p|pg||
pc|sQ|pc|s6|pc|s2|pc|sA|pg||
pc|h5|pc|h8|pc|hA|pc|h2|pg||
pc|dQ|pc|d7|pc|d3|pc|dK|pg||
pc|s5|pc|s7|pc|sJ|pc|sT|pg||
pc|s4|pc|dT|pc|s9|pc|s8|pg||
pc|sK|pc|h6|pc|s3|pc|d8|pg||
pc|hJ|pc|c5|pc|h4|pc|hK|pg||
pc|dA|pc|d4|pc|d2|pc|c6|pg||
pc|hQ|pc|h3|pc|c7|pc|h7|pg||
pc|hT|pc|c2|pc|d6|pc|h9|pg||
pc|d5|pc|dJ|pc|d9|pc|c9|pg||
pc|c3|pc|cK|pc|cA|pc|c4|pg||
pc|cQ|pc|cJ|pc|cT|pc|c8|pg||
pg||
qx|c31|st||md|1S876HA6DQ962CK875,SJ432H9742D7CAQ96,SATHKQT5DAT853CJ4,SKQ95HJ83DKJ4CT32|sv|n|mb|p|mb|p|mb|1D|mb|p|mb|1N|mb|p|mb|p|mb|p|pg||
pc|h7|pc|h5|pc|h8|pc|hA|pg||
pc|d2|pc|d7|pc|dA|pc|d4|pg||
pc|d3|pc|dK|pc|d9|pc|h2|pg||
pc|cT|pc|c8|pc|cQ|pc|c4|pg||
pc|s2|pc|sA|pc|s5|pc|s6|pg||
pc|d5|pc|dJ|pc|dQ|pc|s4|pg||
mc|10|pg||
qx|o32|st||md|2SAJ83HK85DQT5CK87,SK4HJ964DKCAQJT42,ST972HQT7D8742C96,SQ65HA32DAJ963C53|sv|e|mb|1C|mb|p|mb|1D|mb|p|mb|1H|mb|p|mb|2N|mb|p|mb|3N|mb|p|mb|p|mb|p|pg||
pc|s3|pc|sK|pc|sT|pc|s6|pg||
pc|cA|pc|c6|pc|c3|pc|c7|pg||
pc|cQ|pc|c9|pc|c5|pc|c8|pg||
pc|cJ|pc|d8|pc|d6|pc|cK|pg||
pc|hK|pc|h4|pc|h7|pc|h2|pg||
pc|h8|pc|h9|pc|hT|pc|hA|pg||
pc|d3|pc|d5|pc|dK|pc|d2|pg||
pc|cT|pc|d4|pc|h3|pc|dT|pg||
pc|c2|pc|d7|pc|d9|pc|dQ|pg||
pc|c4|pc|s2|pc|dJ|pc|s8|pg||
pc|hJ|pc|hQ|pc|dA|pc|h5|pg||
pc|s7|pc|sQ|pc|sA|pc|s4|pg||
pc|sJ|pc|h6|pc|s9|pc|s5|pg||
pg||
qx|c32|st||md|2SAJ83HK85DQT5CK87,SK4HJ964DKCAQJT42,ST972HQT7D8742C96,SQ65HA32DAJ963C53|sv|e|mb|1C|mb|p|mb|1D|mb|p|mb|1H|mb|p|mb|2N|mb|p|mb|3N|mb|p|mb|p|mb|p|pg||
pc|s3|pc|sK|pc|sT|pc|s5|pg||
pc|cA|pc|c6|pc|c3|pc|c7|pg||
pc|cQ|pc|c9|pc|c5|pc|cK|pg||
pc|hK|pc|h4|pc|h7|pc|h2|pg||
pc|h8|pc|h9|pc|hT|pc|hA|pg||
pc|d3|pc|dT|pc|dK|pc|d2|pg||
pc|cJ|pc|d7|pc|d6|pc|c8|pg||
pc|cT|pc|d4|pc|d9|pc|d5|pg||
pc|c4|pc|d8|pc|dJ|pc|dQ|pg||
pc|c2|pc|s2|pc|h3|pc|s8|pg||
pc|hJ|pc|hQ|pc|s6|pc|h5|pg||
pc|s7|pc|sQ|mc|8|pg||