vg|41st WBTC-BBO5-BB,RR20,I,17,32,EGYPT,0,GERMANY,0|
rs|4HW-1,5DW=,3HE-2,5CN-1,1SS-1,2SN-1,3NW-1,3NW=,2NS=,3NS-1,1SN=,2NW-3,3SW=,4HS-1,1NS+1,2CN+1,4HS=,4HN=,4HW+1,4HW=,2SW+1,4SE-1,4HS+2,6HS=,3NE=,3NW=,4SS=,4SS=,3NE=,3NW+1,2HN+1,2HS+1|
pn|NABIL,SMIRNOV,HUSSEIN,PIEKAREK,ROHOWSKY,NABIL,FRITSCHE,SAMIR|pg||
qx|o17|st||md|3SJT2HJT54DQJCQ874,SQ753HK9DKT84CJ32,SAK984HA6D52CT965,S6HQ8732DA9763CAK|sv|o|mb|1S|mb|2S|an| |mb|d|mb|2N!|mb|p|mb|3D|mb|p|mb|3H|mb|p|mb|4H|mb|p|mb|p|mb|p|pg||
pc|sA|pc|s6|pc|s2|pc|s3|pg||
pc|hA|pc|h2|pc|h4|pc|h9|pg||
pc|h6|pc|h3|pc|hT|pc|hK|pg||
pc|c2|pc|c5|pc|cK|pc|c4|pg||
pc|hQ|pc|h5|pc|d8|pc|s4|pg||
pc|d3|pc|dJ|pc|dK|pc|d2|pg||
pc|dT|pc|d5|pc|d6|pc|dQ|pg||
mc|9|pg||
qx|c17|st||md|3SJT2HJT54DQJCQ874,SQ753HK9DKT84CJ32,SAK984HA6D52CT965,S6HQ8732DA9763CAK|sv|o|mb|1S|mb|2S!|mb|p|mb|4D|mb|p|mb|5D|mb|p|mb|p|mb|p|pg||
pc|sA|pc|s6|pc|s2|pc|s5|pg||
pc|c5|pc|cK|pc|c7|pc|c2|pg||
pc|h2|pc|h4|pc|hK|pc|hA|pg||
pc|c6|pc|cA|pc|c4|pc|c3|pg||
pc|dA|pc|dJ|pc|d4|pc|d2|pg||
pc|d3|pc|dQ|pc|dK|pc|d5|pg||
pc|h9|pc|h6|pc|hQ|pc|h5|pg||
pc|h3|pc|hT|pc|d8|pc|s4|pg||
mc|11|pg||
qx|o18|st||md|4SKT97HDAQ973CA875,SJ863HT72DK854CQ9,SA42HJ964DT2CKJ64,SQ5HAKQ853DJ6CT32|sv|n|mb|1H|mb|d|mb|2H|mb|p|mb|3H|mb|p|mb|p|mb|p|pg||
pc|dA|pc|d4|pc|d2|pc|d6|pg||
pc|dQ|pc|dK|pc|dT|pc|dJ|pg||
pc|c9|pc|c4|pc|c3|pc|cA|pg||
pc|d9|pc|d5|pc|s4|pc|h5|pg||
pc|hQ|pc|d7|pc|h2|pc|h4|pg||
pc|c2|pc|c8|pc|cQ|pc|cK|pg||
pc|sA|pc|s5|pc|s9|pc|s3|pg||
pc|s2|pc|sQ|pc|sK|pc|s6|pg||
pc|c5|pc|h7|pc|c6|pc|cT|pg||
pc|hT|pc|hJ|mc|7|pg||
qx|c18|st||md|4SKT97HDAQ973CA875,SJ863HT72DK854CQ9,SA42HJ964DT2CKJ64,SQ5HAKQ853DJ6CT32|sv|n|mb|1H|mb|d|mb|2H!|mb|3C|mb|3H|mb|4H!|mb|p|mb|4S|mb|p|mb|5C|mb|p|mb|p|mb|p|pg||
pc|hK|pc|c5|pc|h2|pc|h6|pg||
pc|sT|pc|s3|pc|sA|pc|s5|pg||
pc|d2|pc|d6|pc|dQ|pc|dK|pg||
pc|hT|pc|hJ|pc|hQ|pc|c7|pg||
pc|dA|pc|d4|pc|dT|pc|dJ|pg||
pc|d9|pc|d5|pc|s2|pc|c3|pg||
pc|c2|pc|c8|pc|cQ|pc|cK|pg||
pc|s4|pc|sQ|pc|sK|pc|s6|pg||
pc|s7|pc|s8|pc|c4|pc|cT|pg||
pc|h8|pc|d3|pc|h7|pc|h9|pg||
pc|h4|pc|h5|pc|cA|pc|d8|pg||
pc|d7|pc|c9|pc|cJ|pc|h3|pg||
pc|c6|pc|hA|pc|s9|pc|sJ|pg||
pg||
qx|o19|st||md|1SAJ72H82DA62CQT54,SQT96HKT65DT8CK63,S8543HQ97DKQ95CA8,SKHAJ43DJ743CJ972|sv|e|mb|p|mb|p|mb|1D|mb|p|mb|1S|mb|p|mb|p|mb|p|pg||
pc|h5|pc|h7|pc|hJ|pc|h8|pg||
pc|d3|pc|d6|pc|dT|pc|dQ|pg||
pc|s3|pc|sK|pc|sA|pc|s6|pg||
pc|h2|pc|h6|pc|h9|pc|hA|pg||
pc|h3|pc|s2|pc|hK|pc|hQ|pg||
pc|c5|pc|c6|pc|cA|pc|c2|pg||
pc|s4|pc|h4|pc|sJ|pc|sQ|pg||
pc|sT|pc|s5|pc|c7|pc|s7|pg||
pc|s9|pc|s8|pc|d4|pc|c4|pg||
pc|hT|pc|c8|pc|d7|pc|dA|pg||
pc|cK|pc|d5|pc|c9|pc|cT|pg||
mc|6|pg||
qx|c19|st||md|1SAJ72H82DA62CQT54,SQT96HKT65DT8CK63,S8543HQ97DKQ95CA8,SKHAJ43DJ743CJ972|sv|e|mb|1C!|mb|p|mb|1H!|mb|p|mb|2D!|mb|p|mb|2S|mb|p|mb|p|mb|p|pg||
pc|d4|pc|d2|pc|dT|pc|dK|pg||
pc|s3|pc|sK|pc|sA|pc|s6|pg||
pc|dA|pc|d8|pc|d5|pc|d3|pg||
pc|d6|pc|h5|pc|dQ|pc|d7|pg||
pc|d9|pc|dJ|pc|h2|pc|h6|pg||
pc|h4|pc|h8|pc|hK|pc|h7|pg||
pc|hT|pc|hQ|pc|hA|pc|s2|pg||
pc|c4|pc|c6|pc|cA|pc|c2|pg||
pc|h9|pc|hJ|pc|s7|pc|s9|pg||
pc|sQ|pc|s4|pc|h3|pc|sJ|pg||
pc|sT|pc|s5|pc|c7|pc|c5|pg||
pc|cK|pc|c8|pc|c9|pc|cT|pg||
pc|c3|pc|s8|pc|cJ|pc|cQ|pg||
pg||
qx|o20|st||md|2SKT84HJ543D74CJT3,SAQJHAQT6DT52CQ87,S965H82DQJ98CAK42,S732HK97DAK63C965|sv|b|mb|1N|mb|p|mb|3C|an| |mb|p|mb|3D|an| |mb|p|mb|3N|mb|p|mb|p|mb|p|pg||
pc|dQ|pc|dA|pc|d7|pc|d5|pg||
pc|s2|pc|s4|pc|sQ|pc|s5|pg||
pc|hQ|pc|h2|pc|h7|pc|h4|pg||
pc|h6|pc|h8|pc|hK|pc|h3|pg||
pc|s3|pc|s8|pc|sJ|pc|s6|pg||
pc|hA|pc|c2|pc|h9|pc|h5|pg||
pc|sA|pc|s9|pc|s7|pc|sT|pg||
pc|c7|pc|c4|pc|c5|pc|cT|pg||
pc|hJ|pc|hT|pc|d8|pc|d3|pg||
mc|8|pg||
qx|c20|st||md|2SKT84HJ543D74CJT3,SAQJHAQT6DT52CQ87,S965H82DQJ98CAK42,S732HK97DAK63C965|sv|b|mb|1N|mb|p|mb|3N|mb|p|mb|p|mb|p|pg||
pc|s6|pc|s2|pc|sK|pc|sA|pg||
pc|dT|pc|dQ|pc|d3|pc|d7|pg||
pc|d8|pc|dA|pc|d4|pc|d2|pg||
pc|dK|pc|s4|pc|d5|pc|d9|pg||
pc|s3|pc|s8|pc|sQ|pc|s5|pg||
pc|sJ|pc|s9|pc|s7|pc|sT|pg||
pc|hA|pc|h8|pc|h7|pc|h3|pg||
pc|h6|pc|h2|pc|hK|pc|h4|pg||
pc|h9|pc|h5|pc|hT|pc|c2|pg||
pc|hQ|pc|c4|pc|c6|pc|hJ|pg||
mc|9|pg||
qx|o21|st||md|3SA953HK2DJ76CAK42,SQT762HA873DA84CQ,SK8HT64DKQT9CJ865,SJ4HQJ95D532CT973|sv|n|mb|p|mb|p|mb|1N|mb|2C!|mb|d|mb|2H|mb|p|mb|p|mb|2N|mb|p|mb|p|mb|p|pg||
pc|s2|pc|s8|pc|sJ|pc|sA|pg||
pc|d7|pc|d4|pc|dK|pc|d3|pg||
pc|dQ|pc|d2|pc|dJ|pc|dA|pg||
pc|s6|pc|sK|pc|s4|pc|s3|pg||
pc|c5|pc|c3|pc|cA|pc|cQ|pg||
pc|d6|pc|d8|pc|d9|pc|d5|pg||
pc|dT|pc|h5|pc|c2|pc|h3|pg||
pc|cJ|pc|c7|pc|c4|pc|h7|pg||
pc|c6|pc|c9|pc|cK|pc|h8|pg||
mc|8|pg||
qx|c21|st||md|3SA953HK2DJ76CAK42,SQT762HA873DA84CQ,SK8HT64DKQT9CJ865,SJ4HQJ95D532CT973|sv|n|mb|p|mb|p|mb|1C|mb|d|mb|r|mb|1H|mb|3N|mb|p|mb|p|mb|p|pg||
pc|s6|pc|s8|pc|sJ|pc|sA|pg||
pc|d7|pc|dA|pc|d9|pc|d2|pg||
pc|s7|pc|sK|pc|s4|pc|s3|pg||
pc|dK|pc|d3|pc|d6|pc|d4|pg||
pc|dQ|pc|d5|pc|dJ|pc|d8|pg||
pc|dT|pc|h5|pc|s5|pc|h3|pg||
pc|c5|pc|c3|pc|cA|pc|cQ|pg||
pc|c2|pc|h7|pc|cJ|pc|c7|pg||
pc|c6|pc|c9|pc|cK|pc|h8|pg||
mc|8|pg||
qx|o22|st||md|4SKT8HJT8543D2C987,SQ54HQ762D95CAQ42,SAJ72HADKQJT74C63,S963HK9DA863CKJT5|sv|e|mb|p|mb|p|mb|p|mb|1D|mb|p|mb|1H|mb|p|mb|1S|mb|p|mb|p|mb|p|pg||
pc|cJ|pc|c7|pc|cA|pc|c3|pg||
pc|cQ|pc|c6|pc|c5|pc|c8|pg||
pc|c2|pc|s2|pc|cK|pc|c9|pg||
pc|dQ|pc|dA|pc|d2|pc|d5|pg||
pc|h9|pc|h3|pc|h2|pc|hA|pg||
pc|dK|pc|d3|pc|h4|pc|d9|pg||
pc|dJ|pc|d6|pc|h5|pc|s4|pg||
pc|h6|pc|s7|pc|hK|pc|h8|pg||
pc|dT|pc|d8|pc|hT|pc|s5|pg||
pc|hQ|pc|sA|pc|cT|pc|hJ|pg||
pc|sJ|pc|s3|pc|s8|pc|sQ|pg||
mc|7|pg||
qx|c22|st||md|4SKT8HJT8543D2C987,SQ54HQ762D95CAQ42,SAJ72HADKQJT74C63,S963HK9DA863CKJT5|sv|e|mb|1D|mb|2H|mb|2N|mb|p|mb|p|mb|p|pg||
pc|dK|pc|d3|pc|d2|pc|d5|pg||
pc|dQ|pc|dA|pc|c8|pc|d9|pg||
pc|c5|pc|c7|pc|cA|pc|c3|pg||
pc|c2|pc|c6|pc|cT|pc|c9|pg||
pc|cJ|pc|h4|pc|c4|pc|s2|pg||
pc|cK|pc|h3|pc|cQ|pc|s7|pg||
pc|h9|pc|hT|pc|hQ|pc|hA|pg||
pc|dJ|pc|d6|pc|h5|pc|h2|pg||
pc|dT|pc|d8|pc|s8|pc|h6|pg||
pc|d7|pc|s3|pc|hJ|pc|h7|pg||
pc|d4|pc|hK|pc|h8|pc|s4|pg||
pc|sA|pc|s6|pc|sT|pc|s5|pg||
pc|sJ|pc|s9|pc|sK|pc|sQ|pg||
pg||
qx|o23|st||md|1S54HKT542D85CKQ85,SAKQ62H876DJ62CA2,S97HAQJDKQT97CJ64,SJT83H93DA43CT973|sv|b|mb|p|mb|1S|mb|p|mb|2S|mb|p|mb|p|mb|3D|mb|3S|mb|p|mb|p|mb|p|pg||
pc|s9|pc|s3|pc|s4|pc|sA|pg||
pc|s2|pc|s7|pc|sJ|pc|s5|pg||
pc|c7|pc|cQ|pc|cA|pc|c4|pg||
pc|c2|pc|c6|pc|c9|pc|cK|pg||
pc|d8|pc|d2|pc|dT|pc|dA|pg||
pc|c3|pc|c5|pc|sK|pc|cJ|pg||
pc|s6|pc|d7|pc|s8|pc|h2|pg||
pc|cT|pc|c8|pc|d6|mc|9|pg||
qx|c23|st||md|1S54HKT542D85CKQ85,SAKQ62H876DJ62CA2,S97HAQJDKQT97CJ64,SJT83H93DA43CT973|sv|b|mb|p|mb|1S|mb|d|mb|3S!|mb|4H|mb|p|mb|p|mb|p|pg||
pc|sA|pc|s7|pc|sJ|pc|s4|pg||
pc|sK|pc|s9|pc|sT|pc|s5|pg||
pc|d2|pc|dK|pc|d4|pc|d5|pg||
pc|d7|pc|dA|pc|d8|pc|d6|pg||
pc|c7|pc|c5|pc|cA|pc|c4|pg||
pc|c2|pc|cJ|pc|c3|pc|c8|pg||
pc|hA|pc|h3|pc|h2|pc|h6|pg||
pc|hQ|pc|h9|pc|h4|pc|h7|pg||
pc|hJ|pc|s3|pc|hK|pc|h8|pg||
mc|9|pg||
qx|o24|st||md|2ST96HAK6DT74CAK76,SJ85HQJ975DQ3C854,SA43HT3DA865CJ932,SKQ72H842DKJ92CQT|sv|o|mb|p|mb|p|mb|p|mb|1C|mb|p|mb|1D|mb|p|mb|1N|mb|p|mb|p|mb|p|pg||
pc|hQ|pc|h3|pc|h4|pc|hK|pg||
pc|cA|pc|c4|pc|c2|pc|cT|pg||
pc|cK|pc|c5|pc|c3|pc|cQ|pg||
pc|c6|pc|c8|pc|cJ|pc|s2|pg||
pc|c9|pc|h2|pc|c7|pc|s8|pg||
pc|d5|pc|d2|pc|dT|pc|dQ|pg||
pc|sJ|pc|s3|pc|sK|pc|s6|pg||
pc|dK|pc|d4|pc|d3|pc|d6|pg||
pc|dJ|pc|d7|pc|h5|pc|dA|pg||
pc|hT|pc|h8|pc|hA|pc|h7|pg||
pc|s9|pc|s5|pc|s4|pc|sQ|pg||
pc|d9|pc|h6|pc|h9|pc|d8|pg||
pc|s7|pc|sT|pc|hJ|pc|sA|pg||
pg||
qx|c24|st||md|2ST96HAK6DT74CAK76,SJ85HQJ975DQ3C854,SA43HT3DA865CJ932,SKQ72H842DKJ92CQT|sv|o|mb|p|mb|p|mb|1D|mb|p|mb|1H|mb|p|mb|p|mb|d|mb|p|mb|2C|mb|p|mb|p|mb|p|pg||
pc|h2|pc|hA|pc|h7|pc|h3|pg||
pc|cA|pc|c5|pc|c2|pc|cT|pg||
pc|cK|pc|c4|pc|c3|pc|cQ|pg||
pc|c6|pc|c8|pc|cJ|pc|s2|pg||
pc|d5|pc|dJ|pc|d4|pc|d3|pg||
pc|h4|pc|hK|pc|h5|pc|hT|pg||
pc|h6|pc|hJ|pc|c9|pc|h8|pg||
pc|d6|pc|d2|pc|d7|pc|dQ|pg||
pc|s5|pc|s3|pc|sQ|pc|s6|pg||
pc|dK|pc|dT|pc|h9|pc|dA|pg||
pc|d8|pc|d9|pc|c7|pc|s8|pg||
pc|s9|pc|sJ|pc|sA|pc|s7|pg||
pc|s4|pc|sK|pc|sT|pc|hQ|pg||
pg||
qx|o25|st||md|3S5HKQ642DAT742CKT,SJ9763H75DKJ83CA9,SA84HA93DQ65CQ843,SKQT2HJT8D9CJ7652|sv|e|mb|1C|mb|p|mb|1H|mb|p|mb|1N|mb|p|mb|2C!|mb|p|mb|2H|mb|p|mb|4H|mb|p|mb|p|mb|p|pg||
pc|s6|pc|sA|pc|s2|pc|s5|pg||
pc|hA|pc|h8|pc|h2|pc|h5|pg||
pc|h3|pc|hT|pc|hK|pc|h7|pg||
pc|dA|pc|d3|pc|d5|pc|d9|pg||
pc|d2|pc|dK|pc|d6|pc|c6|pg||
pc|s3|pc|s4|pc|sQ|pc|h4|pg||
pc|d4|pc|d8|pc|dQ|pc|c2|pg||
pc|c3|pc|c5|pc|cK|pc|cA|pg||
pc|s7|pc|s8|pc|sK|pc|h6|pg||
mc|10|pg||
qx|c25|st||md|3S5HKQ642DAT742CKT,SJ9763H75DKJ83CA9,SA84HA93DQ65CQ843,SKQT2HJT8D9CJ7652|sv|e|mb|1C|mb|p|mb|1D!|mb|p|mb|1H!|mb|p|mb|2D!|mb|p|mb|2H|mb|p|mb|3D|mb|p|mb|4H|mb|p|mb|p|mb|p|pg||
pc|sK|pc|s5|pc|s9|pc|sA|pg||
pc|c3|pc|c7|pc|cK|pc|cA|pg||
pc|s6|pc|s8|pc|sT|pc|h2|pg||
pc|d2|pc|dK|pc|d6|pc|d9|pg||
pc|c9|pc|cQ|pc|c2|pc|cT|pg||
pc|hA|pc|h8|pc|h4|pc|h5|pg||
pc|h3|pc|hT|pc|hK|pc|h7|pg||
pc|hQ|pc|s3|pc|h9|pc|hJ|pg||
pc|d4|pc|d3|pc|dQ|pc|c5|pg||
pc|d5|pc|s2|pc|dA|pc|d8|pg||
pc|d7|pc|dJ|pc|c4|pc|c6|pg||
mc|10|pg||
qx|o26|st||md|4SJ982HK9DK94CKT52,SK74HAQJ2DJ3CAQ43,SA653HT84DT52CJ76,SQTH7653DAQ876C98|sv|b|mb|p|mb|p|mb|1N|mb|p|mb|2C|mb|p|mb|2H|mb|p|mb|4H|mb|p|mb|p|mb|p|pg||
pc|d2|pc|d6|pc|dK|pc|d3|pg||
pc|d4|pc|dJ|pc|dT|pc|dA|pg||
pc|h3|pc|h9|pc|hJ|pc|h4|pg||
pc|s4|pc|s3|pc|sQ|pc|s2|pg||
pc|h5|pc|hK|pc|hA|pc|h8|pg||
pc|hQ|pc|hT|pc|h6|pc|c2|pg||
pc|sK|pc|sA|pc|sT|pc|s8|pg||
pc|c6|pc|c8|pc|cK|pc|cA|pg||
pc|s7|pc|s5|pc|h7|pc|s9|pg||
mc|11|pg||
qx|c26|st||md|4SJ982HK9DK94CKT52,SK74HAQJ2DJ3CAQ43,SA653HT84DT52CJ76,SQTH7653DAQ876C98|sv|b|mb|p|mb|p|mb|1N|mb|p|mb|2C!|mb|p|mb|2H|mb|p|mb|4H|mb|p|mb|p|mb|p|pg||
pc|d2|pc|d6|pc|dK|pc|d3|pg||
pc|s9|pc|s4|pc|sA|pc|sT|pg||
pc|dT|pc|d8|pc|d4|pc|dJ|pg||
pc|hA|pc|h4|pc|h3|pc|h9|pg||
pc|hQ|pc|h8|pc|h5|pc|hK|pg||
pc|d9|pc|c3|pc|d5|pc|dQ|pg||
pc|h6|pc|c2|pc|hJ|pc|hT|pg||
mc|10|pg||
qx|o27|st||md|1S75HQJDQ954CKT753,SQ83HAK65DAJ63CQ8,SAJ9HT98743DT2CA2,SKT642H2DK87CJ964|sv|o|mb|p|mb|1N|mb|p|mb|2H|mb|p|mb|2S|mb|p|mb|p|mb|p|pg||
pc|hT|pc|h2|pc|hJ|pc|hA|pg||
pc|s3|pc|s9|pc|sT|pc|s5|pg||
pc|s2|pc|s7|pc|sQ|pc|sA|pg||
pc|cA|pc|c4|pc|c3|pc|c8|pg||
pc|c2|pc|c6|pc|cK|pc|cQ|pg||
pc|c5|pc|d3|pc|sJ|pc|c9|pg||
mc|9|pg||
qx|c27|st||md|1S75HQJDQ954CKT753,SQ83HAK65DAJ63CQ8,SAJ9HT98743DT2CA2,SKT642H2DK87CJ964|sv|o|mb|p|mb|1N|mb|2H|mb|2S|mb|3H|mb|3S|mb|p|mb|4S|mb|p|mb|p|mb|p|pg||
pc|hQ|pc|hA|pc|h4|pc|h2|pg||
pc|s3|pc|s9|pc|sK|pc|s5|pg||
pc|s2|pc|s7|pc|s8|pc|sJ|pg||
pc|sA|pc|s4|pc|c7|pc|sQ|pg||
pc|cA|pc|c4|pc|c3|pc|c8|pg||
pc|c2|pc|c6|pc|cK|pc|cQ|pg||
pc|hJ|pc|h5|pc|h3|pc|s6|pg||
pc|cJ|pc|c5|pc|d3|pc|h7|pg||
pc|d7|pc|d4|pc|dJ|pc|d2|pg||
mc|9|pg||
qx|o28|st||md|2SKT8HAQT985DAT72C,SJ73HDJ865CAK8764,SAQ96HKJ4D93CQJ52,S542H7632DKQ4CT93|sv|n|mb|p|mb|1C|mb|p|mb|1H|mb|p|mb|1S|mb|p|mb|2D!|mb|p|mb|2H|mb|p|mb|4C|an| |mb|p|mb|4H|mb|p|mb|p|mb|p|pg||
pc|cA|pc|c2|pc|cT|pc|h5|pg||
pc|d2|pc|d5|pc|d9|pc|dK|pg||
pc|c3|pc|h8|pc|c4|pc|c5|pg||
pc|dA|pc|d6|pc|d3|pc|d4|pg||
pc|d7|pc|d8|pc|hJ|pc|dQ|pg||
pc|h4|pc|h2|pc|hA|pc|c6|pg||
pc|dT|pc|dJ|pc|hK|pc|s4|pg||
pc|s6|pc|s2|pc|sK|pc|s3|pg||
mc|12|pg||
qx|c28|st||md|2SKT8HAQT985DAT72C,SJ73HDJ865CAK8764,SAQ96HKJ4D93CQJ52,S542H7632DKQ4CT93|sv|n|mb|3C|mb|p|mb|5C|mb|5H|mb|p|mb|6H|mb|p|mb|p|mb|p|pg||
pc|cA|pc|c2|pc|c3|pc|h5|pg||
pc|dA|pc|d5|pc|d3|pc|d4|pg||
pc|d7|pc|d6|pc|d9|pc|dQ|pg||
pc|c9|pc|h8|pc|c4|pc|c5|pg||
pc|d2|pc|d8|pc|hJ|pc|dK|pg||
pc|h4|pc|h2|pc|h9|pc|c6|pg||
pc|dT|pc|dJ|pc|hK|pc|s5|pg||
pc|s6|pc|s4|pc|sK|pc|s7|pg||
mc|12|pg||
qx|o29|st||md|3SQ9863HJ32D2CJT63,SKJTHT6DKJ97CAQ75,SA754HKQ87D84CK98,S2HA954DAQT653C42|sv|b|mb|1C|mb|1N|an| |mb|p|mb|2N|mb|p|mb|3D|mb|p|mb|3N|mb|p|mb|p|mb|p|pg||
pc|s9|pc|sT|pc|sA|pc|s2|pg||
pc|hK|pc|hA|pc|h2|pc|h6|pg||
pc|d3|pc|d2|pc|dK|pc|d4|pg||
pc|dJ|pc|d8|pc|dA|pc|s3|pg||
pc|dQ|pc|cJ|pc|d7|pc|c8|pg||
pc|dT|mc|9|pg||
qx|c29|st||md|3SQ9863HJ32D2CJT63,SKJTHT6DKJ97CAQ75,SA754HKQ87D84CK98,S2HA954DAQT653C42|sv|b|mb|1C!|mb|1D|mb|1H!|mb|3N|mb|p|mb|p|mb|p|pg||
pc|hQ|pc|hA|pc|h3|pc|h6|pg||
pc|d3|pc|d2|pc|dK|pc|d4|pg||
pc|dJ|pc|d8|pc|dA|pc|s8|pg||
pc|dQ|pc|s3|pc|d7|pc|s4|pg||
pc|dT|pc|c3|pc|d9|pc|s7|pg||
pc|d6|pc|c6|pc|c5|pc|c8|pg||
pc|d5|pc|cT|pc|c7|pc|h7|pg||
pc|s2|pc|s6|pc|sJ|pc|sA|pg||
pc|hK|pc|h4|pc|h2|pc|hT|pg||
pc|h8|pc|h9|pc|hJ|pc|cQ|pg||
pc|cJ|pc|cA|pc|c9|pc|c2|pg||
pc|sK|pc|s5|pc|c4|pc|s9|pg||
pc|sT|pc|cK|pc|h5|pc|sQ|pg||
pg||
qx|o30|st||md|4SAKJT952HD32C7632,S74H432DKJT6CT984,SQ8HAKQJ85DQ875C5,S63HT976DA94CAKQJ|sv|o|mb|1C!|mb|4S|mb|p|mb|p|mb|p|pg||
pc|c9|pc|c5|pc|cJ|pc|c2|pg||
pc|d4|pc|d2|pc|dK|pc|d5|pg||
pc|dJ|pc|d7|pc|d9|pc|d3|pg||
pc|d6|pc|d8|pc|dA|mc|10|pg||
qx|c30|st||md|4SAKJT952HD32C7632,S74H432DKJT6CT984,SQ8HAKQJ85DQ875C5,S63HT976DA94CAKQJ|sv|o|mb|1C!|mb|4S|mb|p|mb|p|mb|p|pg||
pc|cT|pc|c5|pc|cJ|pc|c2|pg||
pc|dA|pc|d2|pc|d6|pc|d5|pg||
pc|d4|pc|d3|pc|dK|pc|d7|pg||
pc|dJ|pc|dQ|pc|d9|pc|c3|pg||
pc|hA|pc|h6|pc|c6|pc|h2|pg||
pc|s8|pc|s3|pc|sA|pc|s4|pg||
pc|c7|pc|c4|pc|sQ|pc|cQ|pg||
mc|10|pg||
qx|o31|st||md|1SQ97652HAKQDJ6C97,SAJH763DAKT75CKJ3,S43HJT52DQ932CT65,SKT8H984D84CAQ842|sv|n|mb|1S|mb|d|mb|p|mb|1N|mb|p|mb|3N|mb|p|mb|p|mb|p|pg||
pc|hK|pc|h3|pc|h2|pc|h4|pg||
pc|hQ|pc|h6|pc|h5|pc|h8|pg||
pc|hA|pc|h7|pc|hT|pc|h9|pg||
pc|dJ|pc|dA|pc|d2|pc|d4|pg||
pc|cK|pc|c5|pc|c2|pc|c7|pg||
pc|cJ|pc|c6|pc|c4|pc|c9|pg||
pc|c3|pc|cT|pc|cA|pc|s2|pg||
pc|cQ|pc|s5|pc|d5|pc|d3|pg||
pc|c8|pc|s6|pc|d7|pc|s3|pg||
pc|s8|pc|s7|pc|sA|pc|s4|pg||
pc|sJ|pc|hJ|mc|9|pg||
qx|c31|st||md|1SQ97652HAKQDJ6C97,SAJH763DAKT75CKJ3,S43HJT52DQ932CT65,SKT8H984D84CAQ842|sv|n|mb|2S|mb|2N|mb|p|mb|3C!|mb|p|mb|3N|mb|p|mb|p|mb|p|pg||
pc|s4|pc|s8|pc|s9|pc|sJ|pg||
pc|cK|pc|c5|pc|c2|pc|c7|pg||
pc|sA|pc|s3|pc|sT|pc|s2|pg||
pc|cJ|pc|c6|pc|c4|pc|c9|pg||
pc|c3|pc|cT|pc|cA|pc|dJ|pg||
pc|cQ|pc|s5|pc|d7|pc|h2|pg||
pc|c8|pc|d6|pc|h3|pc|d2|pg||
pc|sK|pc|s6|pc|h6|pc|h5|pg||
pc|d4|pc|hA|pc|dK|pc|d3|pg||
pc|dA|pc|d9|pc|d8|pc|hQ|pg||
mc|10|pg||
qx|o32|st||md|2SHT53DQJ8432CAT73,SQJ52HA942D5CJ654,SA7643HKQ76DT7CK2,SKT98HJ8DAK96CQ98|sv|e|mb|p|mb|1S|mb|p|mb|1N|mb|p|mb|2H|mb|p|mb|p|mb|p|pg||
pc|dA|pc|d2|pc|d5|pc|d7|pg||
pc|d6|pc|d3|pc|h2|pc|dT|pg||
pc|hA|pc|h6|pc|h8|pc|h3|pg||
pc|h4|pc|hK|pc|hJ|pc|h5|pg||
pc|h7|mc|9|pg||
qx|c32|st||md|2SHT53DQJ8432CAT73,SQJ52HA942D5CJ654,SA7643HKQ76DT7CK2,SKT98HJ8DAK96CQ98|sv|e|mb|p|mb|1S|mb|p|mb|1N!|mb|p|mb|2D!|mb|p|mb|2H|mb|p|mb|p|mb|p|pg||
pc|d5|pc|d7|pc|dK|pc|d8|pg||
pc|hJ|pc|h3|pc|hA|pc|h6|pg||
pc|h2|pc|hK|pc|h8|pc|h5|pg||
pc|dT|pc|dA|pc|d2|pc|c4|pg||
pc|d9|pc|dJ|pc|h9|pc|hQ|pg||
pc|s3|pc|sK|pc|hT|pc|s2|pg||
pc|dQ|pc|h4|pc|h7|pc|d6|pg||
mc|9|pg||