vg|41st WBTC-BBO6-VC,RR19,I,1,16,POLAND,0,TURKEY,0|
rs|3NN=,3NS=,5CS-1,3NS+1,6CW=,5SE-2,4NS=,3NS+1,2HEx-3,3CN=,4HN=,2HN=,2DW+1,4SW-2,2DN+2,3DN=,1NN+1,1NN=,2NE=,1NE+3,2SE-1,4HSx-1,6HE=,4HE+3,3NN=,2HWx-3,4DS-1,3HWxx-2,4SW=,4SW=,3NE-1,3HS+1|
pn|BALDYSZ,YAVAS,SARNIAK,OYMEN,KURANOGLU,DUFRAT,ACAR,TACZEWSKA|pg||
qx|o1|st||md|3S943HQ2DJT73CQ652,SQJ52H8543DK54CK3,ST8HAKTDAQ962CAJ8,SAK76HJ976D8CT974|sv|o|mb|1C!|mb|p|mb|1D!|mb|p|mb|1N!|mb|p|mb|2C!|mb|p|mb|2D!|mb|p|mb|2N!|mb|p|mb|3N|mb|p|mb|p|mb|p|pg||
pc|sA|pc|s3|pc|s5|pc|s8|pg||
pc|s6|pc|s4|pc|sJ|pc|sT|pg||
pc|s2|pc|c8|pc|sK|pc|s9|pg||
pc|s7|pc|h2|pc|sQ|pc|cJ|pg||
pc|c3|pc|cA|pc|c4|pc|c2|pg||
pc|hT|pc|h7|pc|hQ|pc|h3|pg||
pc|dJ|pc|d4|pc|d2|pc|d8|pg||
pc|dT|pc|d5|pc|d6|pc|c7|pg||
pc|d3|pc|dK|pc|dA|pc|c9|pg||
mc|9|pg||
qx|c1|st||md|3S943HQ2DJT73CQ652,SQJ52H8543DK54CK3,ST8HAKTDAQ962CAJ8,SAK76HJ976D8CT974|sv|o|mb|1D|mb|p|mb|1N|mb|p|mb|3N|mb|p|mb|p|mb|p|pg||
pc|s2|pc|s8|pc|sA|pc|s4|pg||
pc|s6|pc|s3|pc|sJ|pc|sT|pg||
pc|s5|pc|c8|pc|sK|pc|s9|pg||
pc|s7|pc|c5|pc|sQ|pc|cJ|pg||
pc|c3|pc|cA|pc|c4|pc|c2|pg||
pc|hT|pc|h6|pc|hQ|pc|h3|pg||
pc|dJ|pc|dK|pc|dA|pc|d8|pg||
mc|9|pg||
qx|o2|st||md|4SAT6HK52DAQ8CA965,SQ874HQT973DCT742,SK32H6DK7543CKQJ3,SJ95HAJ84DJT962C8|sv|n|mb|p|mb|1N|mb|p|mb|3H!|mb|d|mb|5C|mb|p|mb|p|mb|p|pg||
pc|h3|pc|h6|pc|hA|pc|h2|pg||
pc|c8|pc|c5|pc|c2|pc|cK|pg||
pc|d3|pc|d2|pc|dA|pc|c4|pg||
pc|c7|pc|c3|pc|h4|pc|c9|pg||
pc|cA|pc|cT|pc|cJ|pc|h8|pg||
pc|dQ|pc|h7|pc|d4|pc|d6|pg||
pc|d8|pc|h9|pc|dK|pc|d9|pg||
pc|d5|pc|dT|pc|c6|pc|s4|pg||
pc|hK|pc|hT|pc|s2|pc|hJ|pg||
pc|h5|pc|hQ|pc|cQ|pc|s5|pg||
pc|sK|pc|s9|pc|s6|pc|s7|pg||
pc|s3|pc|sJ|pc|sA|pc|s8|pg||
pc|sT|pc|sQ|pc|d7|pc|dJ|pg||
pg||
qx|c2|st||md|4SAT6HK52DAQ8CA965,SQ874HQT973DCT742,SK32H6DK7543CKQJ3,SJ95HAJ84DJT962C8|sv|n|mb|p|mb|1N|mb|2C!|mb|2S!|mb|3H|mb|3N|mb|p|mb|p|mb|p|pg||
pc|hT|pc|h6|pc|hA|pc|h2|pg||
pc|hJ|pc|hK|pc|h3|pc|s2|pg||
pc|c5|pc|c2|pc|cK|pc|c8|pg||
pc|cQ|pc|d2|pc|c6|pc|c4|pg||
pc|c3|pc|s9|pc|cA|pc|c7|pg||
pc|c9|pc|cT|pc|cJ|pc|s5|pg||
pc|d3|pc|d6|pc|dA|pc|s4|pg||
pc|dQ|mc|10|pg||
qx|o3|st||md|1SQJ942HJT953D95C5,S653HA2DTCAT76432,SHK87DKQJ87643CQJ,SAKT87HQ64DA2CK98|sv|e|mb|p|mb|p|mb|5D|mb|d|mb|p|mb|6C|mb|p|mb|p|mb|p|pg||
pc|dJ|pc|dA|pc|d5|pc|dT|pg||
pc|c8|pc|c5|pc|cA|pc|cJ|pg||
pc|c2|pc|cQ|pc|cK|pc|h5|pg||
pc|d2|pc|d9|pc|c3|pc|d3|pg||
pc|s3|pc|d4|pc|sA|pc|s4|pg||
pc|h4|pc|h3|pc|hA|pc|h7|pg||
pc|h2|pc|hK|pc|h6|pc|h9|pg||
mc|12|pg||
qx|c3|st||md|1SQJ942HJT953D95C5,S653HA2DTCAT76432,SHK87DKQJ87643CQJ,SAKT87HQ64DA2CK98|sv|e|mb|p|mb|p|mb|5D|mb|p|mb|p|mb|d|mb|p|mb|5S|mb|p|mb|p|mb|p|pg||
pc|d9|pc|dT|pc|dJ|pc|dA|pg||
pc|d2|pc|d5|pc|s3|pc|d3|pg||
pc|s5|pc|dQ|pc|s7|pc|s9|pg||
pc|c5|pc|c2|pc|cQ|pc|cK|pg||
pc|c9|pc|h3|pc|cA|pc|cJ|pg||
pc|cT|pc|d8|pc|c8|pc|s2|pg||
pc|hJ|pc|h2|pc|hK|pc|h4|pg||
pc|dK|pc|h6|pc|sJ|pc|hA|pg||
pc|h5|pc|c3|pc|h7|pc|hQ|pg||
pc|sA|pc|s4|pc|s6|pc|d4|pg||
pc|sK|pc|sQ|pc|c4|pc|d6|pg||
mc|9|pg||
qx|o4|st||md|2SAJ2HQ62DK4CAK986,SQT64HT3DJ52CQ754,SK853H8DAQ973CJT2,S97HAKJ9754DT86C3|sv|b|mb|p|mb|p|mb|3H|mb|3N|mb|p|mb|4N|mb|p|mb|p|mb|p|pg||
pc|hT|pc|h8|pc|hK|pc|h2|pg||
pc|hA|pc|h6|pc|h3|pc|s3|pg||
pc|c3|pc|cA|pc|c7|pc|c2|pg||
pc|s2|pc|s4|pc|sK|pc|s7|pg||
pc|cT|pc|h4|pc|cK|pc|c4|pg||
mc|11|pg||
qx|c4|st||md|2SAJ2HQ62DK4CAK986,SQT64HT3DJ52CQ754,SK853H8DAQ973CJT2,S97HAKJ9754DT86C3|sv|b|mb|p|mb|p|mb|3H|mb|3N|mb|p|mb|p|mb|p|pg||
pc|hT|pc|h8|pc|hJ|pc|hQ|pg||
pc|dK|pc|d5|pc|d3|pc|d6|pg||
pc|d4|pc|dJ|pc|dA|pc|dT|pg||
pc|dQ|pc|d8|pc|h2|pc|d2|pg||
pc|d9|pc|h5|pc|h6|pc|c4|pg||
pc|d7|pc|h4|pc|c8|pc|s4|pg||
pc|cJ|pc|c3|pc|cA|pc|c5|pg||
pc|cK|pc|c7|pc|c2|pc|s7|pg||
pc|sA|pc|s6|pc|s3|pc|s9|pg||
pc|s2|pc|sT|pc|sK|pc|h7|pg||
mc|10|pg||
qx|o5|st||md|3SK54HK93DQ76CQT54,SJT63HA5D952CK876,SA98HQ74DKT3CAJ93,SQ72HJT862DAJ84C2|sv|n|mb|1C|mb|1H|mb|1S!|mb|1N|mb|d|mb|p|mb|p|mb|2H|mb|p|mb|p|mb|d!|mb|p|mb|p|mb|p|pg||
pc|h3|pc|h5|pc|hQ|pc|h2|pg||
pc|h4|pc|h6|pc|h9|pc|hA|pg||
pc|s3|pc|s8|pc|sQ|pc|s4|pg||
pc|hJ|pc|hK|pc|d2|pc|h7|pg||
pc|cQ|pc|c6|pc|c3|pc|c2|pg||
pc|c4|pc|c7|pc|cJ|pc|s2|pg||
pc|sA|pc|s7|pc|s5|pc|s6|pg||
pc|s9|pc|h8|pc|sK|pc|sT|pg||
pc|d4|pc|dQ|pc|d5|pc|d3|pg||
pc|c5|pc|c8|pc|c9|pc|hT|pg||
pc|dA|pc|d6|pc|d9|pc|dT|pg||
mc|5|pg||
qx|c5|st||md|3SK54HK93DQ76CQT54,SJT63HA5D952CK876,SA98HQ74DKT3CAJ93,SQ72HJT862DAJ84C2|sv|n|mb|1C|mb|p|mb|1N|mb|p|mb|p|mb|2H|mb|d|mb|p|mb|3C|mb|p|mb|p|mb|p|pg||
pc|hJ|pc|h3|pc|hA|pc|h7|pg||
pc|sJ|pc|s8|pc|s7|pc|sK|pg||
pc|cQ|pc|c6|pc|c3|pc|c2|pg||
pc|c4|pc|c7|pc|c9|pc|h6|pg||
pc|h4|pc|h2|pc|h9|pc|h5|pg||
pc|c5|pc|c8|pc|cJ|pc|h8|pg||
pc|cA|pc|d4|pc|cT|pc|cK|pg||
pc|d3|pc|d8|pc|dQ|pc|d5|pg||
pc|d6|pc|d2|pc|dT|pc|dJ|pg||
pc|sQ|pc|s4|pc|s3|pc|sA|pg||
pc|hQ|pc|hT|pc|hK|pc|d9|pg||
mc|9|pg||
qx|o6|st||md|4S95H873DQJ87CAK87,S842HQ942D963CJT4,SAT73HAKJT6D52C52,SKQJ6H5DAKT4CQ963|sv|e|mb|1D|mb|p|mb|p|mb|1H|mb|d|mb|3C!|mb|p|mb|4H|mb|p|mb|p|mb|p|pg||
pc|dA|pc|d7|pc|d3|pc|d2|pg||
pc|sK|pc|s5|pc|s2|pc|sA|pg||
pc|hA|pc|h5|pc|h3|pc|h2|pg||
pc|d5|pc|dK|pc|d8|pc|d6|pg||
pc|sQ|pc|s9|pc|s4|pc|s3|pg||
pc|sJ|pc|h7|pc|s8|pc|s7|pg||
pc|h8|pc|h4|pc|hJ|pc|d4|pg||
pc|c2|pc|c6|pc|cA|pc|c4|pg||
pc|dQ|pc|d9|pc|sT|pc|dT|pg||
pc|dJ|pc|cT|pc|h6|pc|c3|pg||
pc|c5|pc|c9|pc|cK|pc|cJ|pg||
mc|10|pg||
qx|c6|st||md|4S95H873DQJ87CAK87,S842HQ942D963CJT4,SAT73HAKJT6D52C52,SKQJ6H5DAKT4CQ963|sv|e|mb|1D|mb|p|mb|p|mb|1H|mb|d|mb|2H|mb|p|mb|p|mb|p|pg||
pc|sK|pc|s5|pc|s8|pc|s7|pg||
pc|c3|pc|cA|pc|cJ|pc|c5|pg||
pc|s9|pc|s2|pc|sA|pc|s6|pg||
pc|d2|pc|dK|pc|d7|pc|d6|pg||
pc|sQ|pc|h3|pc|s4|pc|s3|pg||
pc|h7|pc|h2|pc|hA|pc|h5|pg||
pc|d5|pc|dA|pc|d8|pc|d3|pg||
pc|sJ|pc|h8|pc|h9|pc|sT|pg||
pc|cT|pc|c2|pc|c6|pc|cK|pg||
pc|dJ|pc|d9|pc|h6|pc|d4|pg||
pc|hK|pc|dT|pc|c7|pc|h4|pg||
pc|hJ|pc|c9|pc|c8|pc|hQ|pg||
pc|c4|pc|hT|pc|cQ|pc|dQ|pg||
pg||
qx|o7|st||md|1S4HJ9532DA4CK9843,SAKQ2H4DKJT3C7652,ST8753HKT7D986CAQ,SJ96HAQ86DQ752CJT|sv|b|mb|p|mb|1D|mb|p|mb|1H|mb|p|mb|1S|mb|p|mb|2D|mb|p|mb|p|mb|p|pg||
pc|s8|pc|sJ|pc|s4|pc|s2|pg||
pc|d2|pc|dA|pc|d3|pc|d6|pg||
pc|c3|pc|c2|pc|cQ|pc|cT|pg||
pc|s3|pc|s6|pc|d4|pc|sQ|pg||
pc|c4|pc|c5|pc|cA|pc|cJ|pg||
pc|s5|pc|s9|pc|c8|pc|sK|pg||
pc|sA|pc|s7|pc|h6|pc|h2|pg||
pc|c6|pc|d9|pc|dQ|pc|c9|pg||
pc|d5|pc|h3|pc|dT|pc|d8|pg||
pc|c7|mc|9|pg||
qx|c7|st||md|1S4HJ9532DA4CK9843,SAKQ2H4DKJT3C7652,ST8753HKT7D986CAQ,SJ96HAQ86DQ752CJT|sv|b|mb|p|mb|1D|mb|p|mb|1H|mb|p|mb|1S|mb|p|mb|3D|mb|p|mb|3S|mb|p|mb|4S|mb|p|mb|p|mb|p|pg||
pc|s3|pc|s6|pc|s4|pc|sA|pg||
pc|h4|pc|h7|pc|hQ|pc|h2|pg||
pc|cT|pc|c3|pc|c2|pc|cQ|pg||
pc|s5|pc|s9|pc|h3|pc|sK|pg||
pc|dJ|pc|d6|pc|d2|pc|dA|pg||
pc|cK|pc|c5|pc|cA|pc|cJ|pg||
pc|s7|pc|sJ|pc|d4|pc|s2|pg||
pc|hA|pc|h5|pc|c6|pc|hT|pg||
pc|d5|pc|c4|pc|dK|pc|d8|pg||
pc|dT|pc|d9|pc|d7|pc|h9|pg||
pc|d3|pc|s8|pc|dQ|pc|c8|pg||
pc|hK|pc|h6|pc|hJ|pc|sQ|pg||
pc|c7|pc|sT|pc|h8|pc|c9|pg||
pg||
qx|o8|st||md|2SAJ5HAQ53DQ64C842,S863HJ7DKJCAQ9765,SK4HK98DAT752CJT3,SQT972HT642D983CK|sv|o|mb|1C!|mb|p|mb|1S|mb|p|mb|2C|mb|p|mb|p|mb|d|mb|p|mb|2D|mb|p|mb|p|mb|p|pg||
pc|cK|pc|c2|pc|c7|pc|c3|pg||
pc|s9|pc|sJ|pc|s3|pc|s4|pg||
pc|d4|pc|dJ|pc|dA|pc|d3|pg||
pc|sK|pc|s2|pc|s5|pc|s6|pg||
pc|h8|pc|h4|pc|hQ|pc|h7|pg||
pc|sA|pc|s8|pc|cT|pc|s7|pg||
pc|d6|pc|dK|pc|d5|pc|d8|pg||
pc|cA|pc|cJ|pc|h2|pc|c4|pg||
pc|cQ|pc|dT|pc|h6|pc|c8|pg||
pc|d2|pc|d9|pc|dQ|pc|c5|pg||
mc|10|pg||
qx|c8|st||md|2SAJ5HAQ53DQ64C842,S863HJ7DKJCAQ9765,SK4HK98DAT752CJT3,SQT972HT642D983CK|sv|o|mb|2C|mb|p|mb|2D!|mb|p|mb|3C|mb|p|mb|p|mb|d|mb|p|mb|3D|mb|p|mb|p|mb|p|pg||
pc|cK|pc|c2|pc|c5|pc|c3|pg||
pc|sT|pc|sA|pc|s3|pc|s4|pg||
pc|dQ|pc|dK|pc|dA|pc|d3|pg||
pc|h8|pc|h2|pc|hA|pc|h7|pg||
pc|d4|pc|dJ|pc|d2|pc|d8|pg||
pc|cA|pc|cJ|pc|s9|pc|c4|pg||
pc|cQ|pc|cT|pc|sQ|pc|c8|pg||
pc|s6|pc|sK|pc|s2|pc|s5|pg||
pc|dT|pc|d9|pc|d6|pc|c6|pg||
mc|9|pg||
qx|o9|st||md|3SKQ73HQ75D98CAQ72,SA92HJ8DK642CJT53,SJTHAT63DT753CK86,S8654HK942DAQJC94|sv|e|mb|p|mb|p|mb|1C!|mb|p|mb|1H|mb|p|mb|1S|mb|p|mb|1N|mb|p|mb|p|mb|p|pg||
pc|dQ|pc|d8|pc|d6|pc|d3|pg||
pc|dA|pc|d9|pc|d2|pc|d5|pg||
pc|dJ|pc|h5|pc|dK|pc|d7|pg||
pc|d4|pc|dT|pc|c4|pc|h7|pg||
pc|sJ|pc|s4|pc|s3|pc|s2|pg||
pc|sT|pc|s5|pc|s7|pc|sA|pg||
pc|h8|pc|hA|pc|h2|pc|hQ|pg||
mc|8|pg||
qx|c9|st||md|3SKQ73HQ75D98CAQ72,SA92HJ8DK642CJT53,SJTHAT63DT753CK86,S8654HK942DAQJC94|sv|e|mb|p|mb|p|mb|1C|mb|p|mb|1H|mb|p|mb|1S|mb|p|mb|1N|mb|p|mb|p|mb|p|pg||
pc|h2|pc|h5|pc|hJ|pc|hA|pg||
pc|sJ|pc|s4|pc|s3|pc|s9|pg||
pc|sT|pc|s6|pc|s7|pc|s2|pg||
pc|c6|pc|c4|pc|cQ|pc|c3|pg||
pc|sK|pc|sA|pc|h3|pc|s5|pg||
pc|c5|pc|cK|pc|c9|pc|c2|pg||
pc|c8|pc|h4|pc|cA|pc|cT|pg||
pc|sQ|pc|d2|pc|h6|pc|s8|pg||
pc|h7|pc|h8|pc|hT|pc|hK|pg||
pc|dA|pc|d8|pc|d4|pc|d3|pg||
pc|dQ|pc|d9|pc|d6|pc|d5|pg||
pc|dJ|pc|c7|pc|dK|pc|d7|pg||
pc|cJ|pc|dT|pc|h9|pc|hQ|pg||
pg||
qx|o10|st||md|4SQJ5HK7DAT6CQ8632,SKT8HJT85DK73CK75,SA9762HQ964D984C9,S43HA32DQJ52CAJT4|sv|b|mb|1D|mb|p|mb|1H|mb|p|mb|1N|mb|p|mb|p|mb|2S|mb|p|mb|p|mb|d|mb|p|mb|2N|mb|p|mb|p|mb|p|pg||
pc|sQ|pc|sK|pc|s2|pc|s3|pg||
pc|d3|pc|d4|pc|dQ|pc|dA|pg||
pc|c3|pc|c5|pc|c9|pc|cT|pg||
pc|d2|pc|d6|pc|dK|pc|d8|pg||
pc|d7|pc|d9|pc|dJ|pc|dT|pg||
pc|d5|pc|c6|pc|h5|pc|h4|pg||
pc|c4|pc|c2|pc|cK|pc|s6|pg||
pc|c7|pc|s7|pc|cA|pc|c8|pg||
pc|hA|pc|h7|pc|h8|pc|h6|pg||
mc|8|pg||
qx|c10|st||md|4SQJ5HK7DAT6CQ8632,SKT8HJT85DK73CK75,SA9762HQ964D984C9,S43HA32DQJ52CAJT4|sv|b|mb|1C!|mb|p|mb|1H|mb|p|mb|1N|mb|p|mb|p|mb|p|pg||
pc|c3|pc|c5|pc|c9|pc|cJ|pg||
pc|d2|pc|dT|pc|dK|pc|d4|pg||
pc|d3|pc|d9|pc|dQ|pc|dA|pg||
pc|c2|pc|c7|pc|s6|pc|c4|pg||
pc|cK|pc|s2|pc|cT|pc|c6|pg||
pc|d7|pc|d8|pc|dJ|pc|d6|pg||
pc|d5|pc|cQ|pc|h5|pc|s7|pg||
pc|h2|pc|hK|pc|h8|pc|h4|pg||
pc|c8|pc|s8|pc|s9|pc|cA|pg||
pc|s3|pc|sQ|pc|sT|pc|sA|pg||
pc|h6|pc|h3|pc|h7|pc|hT|pg||
mc|10|pg||
qx|o11|st||md|1S653HAQ952D9CK764,SQTH8DJT32CQJT953,SJ2HT64DAK765CA82,SAK9874HKJ73DQ84C|sv|o|mb|p|mb|p|mb|1D|mb|1S|mb|d|mb|2C|mb|p|mb|2S|mb|p|mb|p|mb|p|pg||
pc|d9|pc|d2|pc|dK|pc|d4|pg||
pc|s2|pc|s4|pc|s5|pc|sT|pg||
pc|h8|pc|h6|pc|hJ|pc|hQ|pg||
pc|s3|pc|sQ|pc|sJ|pc|s7|pg||
pc|cQ|pc|cA|pc|s8|pc|c4|pg||
pc|sA|pc|s6|pc|c3|pc|c2|pg||
pc|dQ|pc|c6|pc|d3|pc|d5|pg||
pc|d8|pc|h2|pc|dT|pc|dA|pg||
pc|hT|pc|h3|pc|h5|pc|c5|pg||
pc|h4|pc|h7|pc|h9|pc|c9|pg||
pc|hA|pc|cT|pc|c8|pc|hK|pg||
mc|7|pg||
qx|c11|st||md|1S653HAQ952D9CK764,SQTH8DJT32CQJT953,SJ2HT64DAK765CA82,SAK9874HKJ73DQ84C|sv|o|mb|p|mb|3C|mb|p|mb|p|mb|3H|mb|p|mb|4H|mb|d|mb|p|mb|p|mb|p|pg||
pc|cQ|pc|c2|pc|s4|pc|cK|pg||
pc|s5|pc|sT|pc|sJ|pc|sK|pg||
pc|sA|pc|s3|pc|sQ|pc|s2|pg||
pc|s7|pc|s6|pc|h8|pc|hT|pg||
pc|h4|pc|h3|pc|h9|pc|c3|pg||
pc|d9|pc|d2|pc|dA|pc|d4|pg||
pc|dK|pc|d8|pc|c4|pc|d3|pg||
pc|h6|pc|h7|pc|hQ|pc|c5|pg||
pc|hA|pc|c9|pc|d5|pc|hJ|pg||
pc|h2|pc|dT|pc|c8|pc|hK|pg||
pc|s9|pc|h5|pc|cT|pc|d6|pg||
pc|c6|pc|cJ|pc|cA|pc|s8|pg||
pc|d7|pc|dQ|pc|c7|pc|dJ|pg||
pg||
qx|o12|st||md|2SAQ98754H3DQ3C865,STHAQ95DAKJTCKJ74,S32H876D98542CQ93,SKJ6HKJT42D76CAT2|sv|n|mb|1D|mb|p|mb|1H|mb|1S|mb|3S!|mb|p|mb|4C|mb|p|mb|4D|mb|p|mb|4H|mb|p|mb|4N|mb|p|mb|5S|mb|p|mb|6H|mb|p|mb|p|mb|p|pg||
pc|sA|pc|sT|pc|s3|pc|s6|pg||
pc|d3|pc|dA|pc|d2|pc|d7|pg||
pc|hA|pc|h6|pc|h2|pc|h3|pg||
pc|hQ|pc|h7|pc|h4|pc|s4|pg||
pc|h5|pc|h8|pc|hK|pc|s5|pg||
pc|d6|pc|dQ|mc|12|pg||
qx|c12|st||md|2SAQ98754H3DQ3C865,STHAQ95DAKJTCKJ74,S32H876D98542CQ93,SKJ6HKJT42D76CAT2|sv|n|mb|1D|mb|p|mb|1H|mb|3S|mb|4H|mb|p|mb|p|mb|p|pg||
pc|c5|pc|c4|pc|cQ|pc|cA|pg||
pc|h2|pc|h3|pc|hQ|pc|h6|pg||
pc|hA|pc|h7|pc|h4|pc|s4|pg||
pc|h5|pc|h8|pc|hK|pc|s5|pg||
pc|d6|pc|d3|pc|dA|pc|d2|pg||
pc|dK|pc|d4|pc|d7|pc|dQ|pg||
pc|dJ|pc|d5|pc|s6|pc|s7|pg||
pc|dT|pc|d8|pc|sJ|pc|s8|pg||
mc|13|pg||
qx|o13|st||md|3SAJ95H853DAK32CJ5,SQT6HKQJ4D65CA942,SK87HA76DJT4CKQ87,S432HT92DQ987CT63|sv|b|mb|1C|mb|p|mb|1S|mb|p|mb|1N|mb|p|mb|2D!|mb|p|mb|2S|mb|p|mb|2N|mb|p|mb|3C|mb|p|mb|3N|mb|p|mb|p|mb|p|pg||
pc|hT|pc|h3|pc|hJ|pc|h6|pg||
pc|hK|pc|h7|pc|h9|pc|h5|pg||
pc|h4|pc|hA|pc|h2|pc|h8|pg||
pc|c7|pc|c3|pc|cJ|pc|cA|pg||
pc|hQ|pc|s8|pc|c6|pc|c5|pg||
pc|c2|pc|cK|pc|cT|pc|s5|pg||
pc|dJ|pc|dQ|pc|dA|pc|d5|pg||
pc|dK|pc|d6|pc|d4|pc|d7|pg||
pc|d2|pc|s6|pc|dT|pc|d8|pg||
pc|cQ|pc|s2|pc|d3|pc|c4|pg||
pc|sK|pc|s3|pc|s9|pc|sT|pg||
pc|s7|pc|s4|pc|sA|pc|sQ|pg||
pc|sJ|pc|c9|pc|c8|pc|d9|pg||
pg||
qx|c13|st||md|3SAJ95H853DAK32CJ5,SQT6HKQJ4D65CA942,SK87HA76DJT4CKQ87,S432HT92DQ987CT63|sv|b|mb|1C|mb|p|mb|1S|mb|d|mb|r!|mb|p|mb|p|mb|1N|mb|p|mb|p|mb|d|mb|2C|mb|d|mb|2D|mb|d|mb|2H|mb|p|mb|p|mb|d|mb|p|mb|p|mb|p|pg||
pc|s7|pc|s2|pc|sA|pc|s6|pg||
pc|s5|pc|sQ|pc|sK|pc|s3|pg||
pc|s8|pc|s4|pc|sJ|pc|sT|pg||
pc|c5|pc|cA|pc|c7|pc|c3|pg||
pc|d5|pc|dJ|pc|dQ|pc|dK|pg||
pc|cJ|pc|c2|pc|c8|pc|c6|pg||
pc|dA|pc|d6|pc|d4|pc|d7|pg||
pc|d3|pc|hK|pc|dT|pc|d8|pg||
pc|c4|pc|cQ|pc|cT|pc|d2|pg||
pc|cK|pc|hT|pc|h3|pc|c9|pg||
pc|h9|pc|h5|pc|h4|pc|hA|pg||
mc|5|pg||
qx|o14|st||md|4SAK943H6DAQ984CAT,SQJHAJ985DKT63CKQ,S5HQT73D752C87652,ST8762HK42DJCJ943|sv|o|mb|p|mb|1S|mb|2H|mb|p|mb|p|mb|d|mb|p|mb|3C|mb|3H|mb|4D|mb|p|mb|p|mb|p|pg||
pc|cK|pc|c2|pc|c3|pc|cA|pg||
pc|h6|pc|hA|pc|h3|pc|h2|pg||
pc|cQ|pc|c5|pc|c4|pc|cT|pg||
pc|h9|pc|hT|pc|hK|pc|d4|pg||
pc|sA|pc|sJ|pc|s5|pc|s2|pg||
pc|sK|pc|sQ|pc|c6|pc|s6|pg||
pc|s3|pc|h5|pc|d2|pc|s7|pg||
pc|hQ|pc|h4|pc|s4|pc|h8|pg||
pc|h7|pc|dJ|pc|dQ|pc|hJ|pg||
pc|s9|pc|dT|pc|c7|pc|s8|pg||
pc|d3|pc|d5|pc|c9|pc|d8|pg||
pc|dA|pc|d6|pc|d7|pc|cJ|pg||
pc|d9|pc|dK|pc|c8|pc|sT|pg||
pg||
qx|c14|st||md|4SAK943H6DAQ984CAT,SQJHAJ985DKT63CKQ,S5HQT73D752C87652,ST8762HK42DJCJ943|sv|o|mb|p|mb|1S|mb|2H|mb|p|mb|3H|mb|d|mb|r|mb|p|mb|p|mb|p|pg||
pc|s5|pc|s2|pc|sA|pc|sJ|pg||
pc|sK|pc|sQ|pc|d2|pc|s6|pg||
pc|s9|pc|h8|pc|hT|pc|s7|pg||
pc|d5|pc|dJ|pc|dA|pc|d3|pg||
pc|cA|pc|cQ|pc|c2|pc|c3|pg||
pc|s4|pc|hA|pc|d7|pc|s8|pg||
pc|cK|pc|c5|pc|c4|pc|cT|pg||
pc|dK|pc|h7|pc|sT|pc|d4|pg||
pc|c6|pc|c9|pc|h6|pc|h9|pg||
pc|hJ|pc|h3|pc|h2|pc|s3|pg||
pc|h5|pc|hQ|pc|hK|pc|d8|pg||
pc|cJ|pc|d9|pc|d6|pc|c7|pg||
pc|h4|pc|dQ|pc|dT|pc|c8|pg||
pg||
qx|o15|st||md|1ST7H864DQ84C97652,SAJ8653HKDJ532CA3,SQ94HQJ92DKT9CKQT,SK2HAT753DA76CJ84|sv|n|mb|p|mb|1S|mb|p|mb|2H|mb|p|mb|2S|mb|p|mb|2N!|mb|p|mb|3D|mb|p|mb|3S|mb|p|mb|4S|mb|p|mb|p|mb|p|pg||
pc|cK|pc|c4|pc|c6|pc|cA|pg||
pc|hK|pc|h2|pc|h3|pc|h4|pg||
pc|c3|pc|cQ|pc|c8|pc|c2|pg||
pc|hQ|pc|hA|pc|h8|pc|d2|pg||
pc|cJ|pc|c5|pc|d3|pc|cT|pg||
pc|s2|pc|s7|pc|sA|pc|s4|pg||
pc|s3|pc|s9|pc|sK|pc|sT|pg||
pc|h5|pc|h6|pc|s5|pc|h9|pg||
mc|10|pg||
qx|c15|st||md|1ST7H864DQ84C97652,SAJ8653HKDJ532CA3,SQ94HQJ92DKT9CKQT,SK2HAT753DA76CJ84|sv|n|mb|p|mb|1S|mb|p|mb|2H|mb|p|mb|2S|mb|p|mb|2N|mb|p|mb|3S|mb|p|mb|4S|mb|p|mb|p|mb|p|pg||
pc|cK|pc|c4|pc|c2|pc|cA|pg||
pc|c3|pc|cQ|pc|c8|pc|c5|pg||
pc|cT|pc|cJ|pc|c6|pc|d2|pg||
pc|h3|pc|h4|pc|hK|pc|h2|pg||
pc|s3|pc|s4|pc|sK|pc|s7|pg||
pc|s2|pc|sT|pc|sJ|pc|sQ|pg||
pc|hQ|pc|hA|pc|h6|pc|d3|pg||
pc|dA|pc|d4|pc|d5|pc|d9|pg||
pc|d6|pc|d8|pc|dJ|pc|dK|pg||
mc|10|pg||
qx|o16|st||md|2S53HA9832DQCKJ764,S9642HJDAKJ72CQ53,SKJ87HQT65DT863CT,SAQTHK74D954CA982|sv|e|mb|1D|mb|p|mb|2C|mb|p|mb|2D|mb|p|mb|2N|mb|p|mb|3C|mb|p|mb|3N|mb|p|mb|p|mb|p|pg||
pc|h3|pc|hJ|pc|hQ|pc|hK|pg||
pc|d4|pc|dQ|pc|dA|pc|d3|pg||
pc|dK|pc|d6|pc|d5|pc|c4|pg||
pc|s2|pc|s7|pc|sT|pc|s5|pg||
pc|d9|pc|c6|pc|dJ|pc|d8|pg||
pc|s4|pc|s8|pc|sQ|pc|s3|pg||
pc|sA|pc|c7|pc|s6|pc|sK|pg||
pc|cA|pc|cJ|pc|c3|pc|cT|pg||
pc|c9|pc|cK|pc|c5|pc|h5|pg||
mc|8|pg||
qx|c16|st||md|2S53HA9832DQCKJ764,S9642HJDAKJ72CQ53,SKJ87HQT65DT863CT,SAQTHK74D954CA982|sv|e|mb|p|mb|p|mb|1C|mb|1H|mb|d|mb|3C!|mb|p|mb|3H|mb|p|mb|p|mb|p|pg||
pc|dA|pc|d3|pc|d9|pc|dQ|pg||
pc|hJ|pc|hQ|pc|h4|pc|h2|pg||
pc|cT|pc|c2|pc|cK|pc|c5|pg||
pc|c4|pc|c3|pc|h5|pc|c8|pg||
pc|d6|pc|d4|pc|h3|pc|d2|pg||
pc|c6|pc|cQ|pc|h6|pc|c9|pg||
pc|d8|pc|d5|pc|h8|pc|d7|pg||
pc|c7|pc|dJ|pc|hT|pc|cA|pg||
pc|s7|pc|sT|pc|s3|pc|s2|pg||
pc|sA|pc|s5|pc|s4|pc|s8|pg||
pc|sQ|pc|cJ|pc|s6|pc|sK|pg||
pc|dT|pc|h7|pc|h9|pc|dK|pg||
pc|hA|pc|s9|pc|sJ|pc|hK|pg||
pg||