vg|41st WBTC-BBO2-BB,RR11,I,1,16,INDONESIA,0,ARGENTINA,0|
rs|4SN=,4SN+1,7HE=,7HE=,4HW-2,2SE=,3NSx-5,2HE-1,3NE=,3NE+1,,2SN-3,,,,,,,,,,,,,,,,,,,,|
pn|GEORGE,LAMBARDI,KARWUR,RIZZO,ALUJAS,TOBING,RAVENNA,ASBI|pg||
qx|o1|st||md|3SQ842HQJ852DT62CQ,S97HAKT76D87CT754,SAK53H4DAK9543CK2,SJT6H93DQJCAJ9863|sv|o|mb|1C|mb|p|mb|1D|mb|1H|mb|2D|mb|d|mb|r|mb|2H|mb|2S|mb|p|mb|4S|mb|p|mb|p|mb|p|pg||
pc|h9|pc|hQ|pc|hK|pc|h4|pg||
pc|c5|pc|c2|pc|cA|pc|cQ|pg||
pc|h3|pc|h2|pc|h6|pc|s3|pg||
pc|sA|pc|s6|pc|s2|pc|s7|pg||
pc|dA|pc|dQ|pc|d6|pc|d7|pg||
pc|s5|pc|sT|pc|sQ|pc|s9|pg||
pc|dT|pc|d8|pc|d3|pc|dJ|pg||
pc|sJ|pc|s4|pc|h7|pc|sK|pg||
pc|dK|pc|c3|pc|d2|pc|c4|pg||
pc|d9|pc|c6|pc|h5|pc|hT|pg||
pc|d4|pc|c8|pc|h8|pc|c7|pg||
pc|cK|pc|c9|pc|hJ|pc|cT|pg||
pc|d5|pc|cJ|pc|s8|pc|hA|pg||
pg||
qx|c1|st||md|3SQ842HQJ852DT62CQ,S97HAKT76D87CT754,SAK53H4DAK9543CK2,SJT6H93DQJCAJ9863|sv|o|mb|1D|mb|p|mb|1H|mb|p|mb|2S|mb|p|mb|3S|mb|p|mb|4C|mb|p|mb|4S|mb|p|mb|p|mb|p|pg||
pc|s6|pc|s2|pc|s7|pc|sA|pg||
pc|s3|pc|sT|pc|sQ|pc|s9|pg||
pc|d2|pc|d7|pc|dA|pc|dJ|pg||
pc|sK|pc|sJ|pc|s4|pc|h7|pg||
pc|dK|pc|dQ|pc|dT|pc|d8|pg||
mc|11|pg||
qx|o2|st||md|4SQ952H73DAQ98743C,SAKJ8HK96DCAK8754,ST643HTDJT65CQT62,S7HAQJ8542DK2CJ93|sv|n|mb|1H|mb|p|mb|2C|mb|p|mb|3H|mb|p|mb|7H|mb|p|mb|p|mb|p|pg||
pc|h3|pc|h6|pc|hT|pc|hQ|pg||
pc|d2|pc|d3|pc|h9|pc|d5|pg||
pc|sA|pc|s3|pc|s7|pc|s2|pg||
pc|s8|pc|s4|pc|h8|pc|s9|pg||
pc|dK|pc|dA|pc|hK|pc|d6|pg||
pc|sJ|pc|s6|pc|hJ|pc|s5|pg||
pc|hA|pc|h7|pc|c4|pc|c2|pg||
pc|c3|pc|d4|pc|cK|pc|c6|pg||
pc|sK|pc|sT|pc|c9|pc|sQ|pg||
pc|cA|pc|cT|pc|cJ|pc|d7|pg||
pc|c5|pc|cQ|pc|h2|pc|d8|pg||
pc|h4|pc|d9|pc|c7|pc|dT|pg||
pc|h5|pc|dQ|pc|c8|pc|dJ|pg||
pg||
qx|c2|st||md|4SQ952H73DAQ98743C,SAKJ8HK96DCAK8754,ST643HTDJT65CQT62,S7HAQJ8542DK2CJ93|sv|n|mb|4H|mb|p|mb|5N|mb|p|mb|6N|mb|p|mb|7H|mb|p|mb|p|mb|p|pg||
pc|h3|pc|h6|pc|hT|pc|hQ|pg||
pc|d2|pc|d3|pc|h9|pc|d6|pg||
pc|sA|pc|s3|pc|s7|pc|s2|pg||
pc|s8|pc|s4|pc|h2|pc|s5|pg||
pc|dK|pc|dA|pc|hK|pc|d5|pg||
pc|sJ|pc|s6|pc|hJ|pc|s9|pg||
pc|hA|pc|h7|mc|13|pg||
qx|o3|st||md|1SK8H974DKQTCAQ954,SJHKQ85D7543CT873,ST972HT2DA92CKJ62,SAQ6543HAJ63DJ86C|sv|e|mb|1N|mb|p|mb|p|mb|2C|mb|p|mb|3H|mb|p|mb|4H|mb|p|mb|p|mb|p|pg||
pc|c6|pc|h3|pc|c5|pc|c3|pg||
pc|h6|pc|h7|pc|hK|pc|h2|pg||
pc|sJ|pc|s2|pc|s3|pc|sK|pg||
pc|dQ|pc|d5|pc|d9|pc|d6|pg||
pc|dK|pc|d3|pc|d2|pc|d8|pg||
pc|dT|pc|d4|pc|dA|pc|dJ|pg||
pc|c2|pc|hA|pc|c4|pc|c7|pg||
pc|sA|pc|s8|pc|c8|pc|sT|pg||
pc|sQ|pc|h9|pc|hQ|pc|s7|pg||
pc|h5|pc|hT|pc|hJ|pc|h4|pg||
pc|s4|pc|c9|pc|cT|pc|s9|pg||
pc|cK|pc|s5|pc|cQ|pc|h8|pg||
pc|d7|pc|cJ|pc|s6|pc|cA|pg||
pg||
qx|c3|st||md|1SK8H974DKQTCAQ954,SJHKQ85D7543CT873,ST972HT2DA92CKJ62,SAQ6543HAJ63DJ86C|sv|e|mb|1N|mb|p|mb|2C|mb|2S|mb|p|mb|p|mb|p|pg||
pc|dK|pc|d3|pc|d2|pc|d6|pg||
pc|dQ|pc|d4|pc|d9|pc|d8|pg||
pc|dT|pc|d5|pc|dA|pc|dJ|pg||
pc|c6|pc|s3|pc|c4|pc|c3|pg||
pc|s5|pc|sK|pc|sJ|pc|s2|pg||
pc|c5|pc|c7|pc|cJ|pc|s4|pg||
pc|sA|pc|s8|pc|c8|pc|s7|pg||
pc|sQ|pc|c9|pc|cT|pc|s9|pg||
mc|8|pg||
qx|o4|st||md|2SJ942HAJ2DAJ72CQT,SA7HKT9543DQ95CJ7,SKT6H76D84CA98432,SQ853HQ8DKT63CK65|sv|b|mb|2H|mb|p|mb|p|mb|2N|mb|p|mb|3N|mb|d|mb|p|mb|p|mb|p|pg||
pc|hT|pc|h6|pc|hQ|pc|hA|pg||
pc|s4|pc|s7|pc|sT|pc|sQ|pg||
pc|h8|pc|hJ|pc|hK|pc|h7|pg||
pc|h9|pc|c2|pc|c5|pc|h2|pg||
pc|h5|pc|c3|pc|s8|pc|d2|pg||
pc|h4|pc|c4|pc|s3|pc|s2|pg||
pc|h3|pc|d4|pc|s5|pc|s9|pg||
pc|c7|pc|c8|pc|cK|pc|cT|pg||
pc|d3|pc|dJ|pc|dQ|pc|d8|pg||
pc|sA|pc|s6|pc|c6|pc|sJ|pg||
pc|d9|pc|c9|pc|dT|pc|dA|pg||
pc|cQ|pc|cJ|pc|cA|pc|d6|pg||
pc|sK|pc|dK|pc|d7|pc|d5|pg||
pg||
qx|c4|st||md|2SJ942HAJ2DAJ72CQT,SA7HKT9543DQ95CJ7,SKT6H76D84CA98432,SQ853HQ8DKT63CK65|sv|b|mb|2D|mb|p|mb|2H|mb|p|mb|p|mb|p|pg||
pc|s4|pc|s7|pc|sK|pc|s5|pg||
pc|c3|pc|cK|pc|cT|pc|c7|pg||
pc|s3|pc|s2|pc|sA|pc|s6|pg||
pc|h3|pc|h6|pc|h8|pc|hJ|pg||
pc|cQ|pc|cJ|pc|cA|pc|c6|pg||
pc|h7|pc|hQ|pc|hA|pc|h4|pg||
pc|h2|pc|h5|pc|c4|pc|d3|pg||
pc|h9|pc|sT|pc|s8|pc|s9|pg||
pc|dQ|pc|d8|pc|d6|pc|d2|pg||
pc|d5|pc|d4|pc|dT|pc|dJ|pg||
pc|dA|pc|d9|pc|c2|pc|dK|pg||
mc|7|pg||
qx|o5|st||md|3SKQHKQDQJ963CJT63,SJ95HJ8763DK54CK5,ST8762HT954D82C87,SA43HA2DAT7CAQ942|sv|n|mb|p|mb|1C|mb|1D|mb|d|mb|p|mb|2N|mb|p|mb|3N|mb|p|mb|p|mb|p|pg||
pc|dQ|pc|d4|pc|d2|pc|dA|pg||
pc|c4|pc|c3|pc|cK|pc|c7|pg||
pc|h7|pc|h4|pc|h2|pc|hQ|pg||
pc|dJ|pc|dK|pc|d8|pc|d7|pg||
pc|c5|pc|c8|pc|c9|pc|cT|pg||
pc|d6|pc|d5|pc|s7|pc|dT|pg||
pc|hA|pc|hK|pc|h3|pc|h5|pg||
pc|cA|pc|c6|pc|h6|pc|h9|pg||
pc|cQ|pc|cJ|pc|h8|pc|s6|pg||
pc|c2|pc|d3|pc|hJ|pc|hT|pg||
pc|sA|pc|sQ|pc|s5|pc|s2|pg||
pc|s3|pc|sK|pc|s9|pc|s8|pg||
pc|d9|pc|sJ|pc|sT|pc|s4|pg||
pg||
qx|c5|st||md|3SKQHKQDQJ963CJT63,SJ95HJ8763DK54CK5,ST8762HT954D82C87,SA43HA2DAT7CAQ942|sv|n|mb|p|mb|1C|mb|1D|mb|1H|mb|p|mb|2N|mb|p|mb|3D|mb|p|mb|3H|mb|p|mb|3N|mb|p|mb|p|mb|p|pg||
pc|dQ|pc|d4|pc|d8|pc|dA|pg||
pc|hA|pc|hK|pc|h3|pc|h5|pg||
pc|h2|pc|hQ|pc|h6|pc|h4|pg||
pc|cT|pc|cK|pc|c8|pc|c2|pg||
pc|hJ|pc|h9|pc|s3|pc|d3|pg||
pc|h8|pc|hT|pc|s4|pc|d6|pg||
pc|c7|pc|cA|pc|c3|pc|c5|pg||
pc|cQ|pc|c6|pc|s5|pc|s2|pg||
pc|c4|pc|cJ|pc|s9|pc|s7|pg||
mc|10|pg||
qx|c6|st||md|4S64HAQJ64DT92CAT4,ST8HKT85DAJ5CKQ32,SAQ953H7DQ3CJ9876,SKJ72H932DK8764C5|sv|e|mb|p|mb|1H|mb|p|mb|1S|mb|p|mb|1N|mb|p|mb|2S|mb|p|mb|p|mb|p|pg||
pc|d4|pc|d2|pc|dA|pc|d3|pg||
pc|d5|pc|dQ|pc|dK|pc|d9|pg||
pc|d8|pc|dT|pc|dJ|pc|s3|pg||
pc|c7|pc|c5|pc|cT|pc|cQ|pg||
pc|s8|pc|s9|pc|sJ|pc|s4|pg||
pc|h2|pc|hA|pc|h5|pc|h7|pg||
pc|s6|pc|sT|pc|sQ|pc|sK|pg||
pc|d7|pc|h4|pc|h8|pc|s5|pg||
pc|sA|pc|s2|pc|h6|pc|hT|pg||
pc|cJ|pc|h3|pc|cA|pc|c3|pg||
pc|hJ|pc|hK|pc|c6|pc|h9|pg||
mc|5|pg||