vg|41st WBTC-BBO6-VC,RR12,I,17,32,SWEDEN,0,ENGLAND,0|
rs|3NN+2,2SEx=,3SW+1,3SW+1,3NN=,3NS+2,2SW-5,2HN+3,4SW+1,4SW+1,6HS+1,6HS=,4HS+1,4HS+1,5DE=,4DE=,1SE-2,1SN-1,3NE-2,2NE=,1NN+4,1NN=,4SN+1,4SS=,5CS=,4CN+2,4SE+2,3NN=,3NS+2,3NS+4,3HN=,3HN+1|
pn|AHLESVED,STOCKDALE,GRONKVIST,F BROWN,DHONDY,LARSSON,SENIOR,BERTHEAU|pg||
qx|o17|st||md|3SHKQ9432D865CAKJ5,SJ83HJ8DA942CT632,SAQ92H5DKQJ73CQ94,SKT7654HAT76DTC87|sv|o|mb|1D!|mb|1S|mb|d|mb|2S|mb|2N|mb|p|mb|3H|mb|p|mb|3N|mb|p|mb|p|mb|p|pg||
pc|s6|pc|h2|pc|sJ|pc|sQ|pg||
pc|c4|pc|c8|pc|cA|pc|c3|pg||
pc|d5|pc|d2|pc|dK|pc|dT|pg||
pc|h5|pc|h6|pc|hK|pc|h8|pg||
pc|d6|pc|dA|pc|d3|pc|h7|pg||
pc|s8|pc|sA|pc|s4|pc|h3|pg||
pc|cQ|pc|c7|pc|c5|pc|c2|pg||
pc|c9|pc|s5|pc|cJ|pc|c6|pg||
pc|cK|pc|cT|pc|s2|pc|hT|pg||
pc|d8|pc|d4|pc|dQ|pc|s7|pg||
pc|dJ|pc|sT|pc|h4|pc|d9|pg||
pc|d7|pc|hA|pc|h9|pc|hJ|pg||
pc|s9|pc|sK|pc|hQ|pc|s3|pg||
pg||
qx|c17|st||md|3SHKQ9432D865CAKJ5,SJ83HJ8DA942CT632,SAQ92H5DKQJ73CQ94,SKT7654HAT76DTC87|sv|o|mb|1D|mb|1S|mb|2H|mb|2S|mb|p|mb|p|mb|d|mb|p|mb|p|mb|p|pg||
pc|cK|pc|c2|pc|c9|pc|c8|pg||
pc|cA|pc|c3|pc|c4|pc|c7|pg||
pc|c5|pc|c6|pc|cQ|pc|s4|pg||
pc|h6|pc|h2|pc|hJ|pc|h5|pg||
pc|h8|pc|d7|pc|hA|pc|h3|pg||
pc|h7|pc|h9|pc|s8|pc|s9|pg||
pc|dK|pc|dT|pc|d8|pc|dA|pg||
pc|cT|pc|d3|pc|s5|pc|cJ|pg||
pc|hT|pc|hQ|pc|sJ|pc|sQ|pg||
pc|s2|pc|sT|pc|d5|pc|s3|pg||
pc|s6|pc|d6|pc|d2|pc|sA|pg||
pc|dJ|pc|s7|pc|h4|pc|d4|pg||
pc|sK|pc|hK|pc|d9|pc|dQ|pg||
pg||
qx|o18|st||md|4SKQHJ98732DQ6CKT7,SA98632HAQT4DJ8C3,ST5H5DAK9743CQJ42,SJ74HK6DT52CA9865|sv|n|mb|p|mb|1H|mb|1S|mb|2D!|mb|2S|mb|p|mb|p|mb|3C|mb|p|mb|3D|mb|3S|mb|p|mb|p|mb|p|pg||
pc|h5|pc|h6|pc|hJ|pc|hA|pg||
pc|sA|pc|s5|pc|s4|pc|sK|pg||
pc|s2|pc|sT|pc|sJ|pc|sQ|pg||
pc|dQ|pc|d8|pc|d3|pc|d2|pg||
pc|d6|pc|dJ|pc|dK|pc|d5|pg||
mc|10|pg||
qx|c18|st||md|4SKQHJ98732DQ6CKT7,SA98632HAQT4DJ8C3,ST5H5DAK9743CQJ42,SJ74HK6DT52CA9865|sv|n|mb|p|mb|1H|mb|1S|mb|2D|mb|2S|mb|p|mb|3S|mb|p|mb|p|mb|p|pg||
pc|h5|pc|h6|pc|hJ|pc|hQ|pg||
pc|sA|pc|s5|pc|s4|pc|sQ|pg||
pc|s2|pc|sT|pc|sJ|pc|sK|pg||
mc|10|pg||
qx|o19|st||md|1SQT85HAQJ3DA7C952,SAJH764D98543CK43,SK97H85DKQJ2CAJT7,S6432HKT92DT6CQ86|sv|e|mb|1D!|mb|p|mb|2C!|mb|p|mb|2H|mb|p|mb|3N|mb|p|mb|p|mb|p|pg||
pc|dT|pc|dA|pc|d5|pc|d2|pg||
pc|c9|pc|c3|pc|c7|pc|cQ|pg||
pc|d6|pc|d7|pc|d3|pc|dK|pg||
pc|h5|pc|h2|pc|hJ|pc|h6|pg||
pc|c2|pc|c4|pc|cJ|pc|c6|pg||
pc|s7|pc|s2|pc|s5|pc|sJ|pg||
pc|cK|pc|cA|pc|c8|pc|c5|pg||
pc|dQ|pc|s3|pc|h3|pc|d4|pg||
pc|cT|pc|h9|pc|s8|pc|h4|pg||
pc|dJ|pc|s4|pc|hQ|pc|d8|pg||
pc|s9|pc|s6|pc|sQ|pc|sA|pg||
pc|d9|pc|h8|pc|hT|pc|sT|pg||
pc|h7|pc|sK|pc|hK|pc|hA|pg||
pg||
qx|c19|st||md|1SQT85HAQJ3DA7C952,SAJH764D98543CK43,SK97H85DKQJ2CAJT7,S6432HKT92DT6CQ86|sv|e|mb|1C|mb|p|mb|1D|mb|p|mb|1N|mb|p|mb|3N|mb|p|mb|p|mb|p|pg||
pc|h4|pc|h5|pc|hK|pc|hA|pg||
pc|c9|pc|c4|pc|c7|pc|cQ|pg||
pc|hT|pc|hQ|pc|h6|pc|h8|pg||
pc|c2|pc|c3|pc|cT|pc|c8|pg||
pc|s7|pc|s2|pc|sQ|pc|sA|pg||
pc|h7|pc|s9|pc|h2|pc|hJ|pg||
pc|c5|pc|cK|mc|11|pg||
qx|o20|st||md|2SAKQ8HK7653D32CJ6,SJT52HA2DAQJTCQ75,S97HJT9DK65CAKT98,S643HQ84D9874C432|sv|b|mb|1N!|mb|p|mb|2C!|mb|p|mb|2S|mb|p|mb|p|mb|p|pg||
pc|hJ|pc|h4|pc|h3|pc|hA|pg||
pc|c5|pc|cT|pc|c2|pc|c6|pg||
pc|hT|pc|h8|pc|h5|pc|h2|pg||
pc|h9|pc|hQ|pc|hK|pc|s2|pg||
pc|c7|pc|c8|pc|c3|pc|cJ|pg||
pc|sA|pc|s5|pc|s7|pc|s3|pg||
pc|sK|pc|sT|pc|s9|pc|s4|pg||
pc|sQ|pc|sJ|pc|d5|pc|s6|pg||
pc|h7|pc|dT|pc|c9|pc|d4|pg||
pc|h6|pc|dJ|pc|cK|pc|d7|pg||
pc|d2|pc|dA|pc|d6|pc|d8|pg||
mc|3|pg||
qx|c20|st||md|2SAKQ8HK7653D32CJ6,SJT52HA2DAQJTCQ75,S97HJT9DK65CAKT98,S643HQ84D9874C432|sv|b|mb|1N|mb|p|mb|p|mb|2D!|mb|p|mb|2H|mb|p|mb|p|mb|p|pg||
pc|c2|pc|cJ|pc|cQ|pc|cA|pg||
pc|h9|pc|h4|pc|h3|pc|hA|pg||
pc|dA|pc|d5|pc|d8|pc|d2|pg||
pc|c7|pc|c8|pc|c3|pc|c6|pg||
pc|hT|pc|h8|pc|h5|pc|h2|pg||
pc|hJ|pc|hQ|pc|hK|pc|c5|pg||
pc|d3|pc|dT|pc|dK|pc|d4|pg||
pc|c9|pc|c4|pc|s8|pc|s2|pg||
mc|11|pg||
qx|o21|st||md|3ST7HQ942DJ7542CT7,SAJ9863HA8DA6CK63,SK5HKJ73DKQ93CJ85,SQ42HT65DT8CAQ942|sv|n|mb|1D!|mb|p|mb|p|mb|d|mb|p|mb|2C|mb|p|mb|2S|mb|p|mb|4S|mb|p|mb|p|mb|p|pg||
pc|dK|pc|d8|pc|d2|pc|dA|pg||
pc|sA|pc|s5|pc|s2|pc|s7|pg||
pc|s3|pc|sK|pc|s4|pc|sT|pg||
pc|dQ|pc|dT|pc|d7|pc|d6|pg||
pc|h3|pc|h5|pc|hQ|pc|hA|pg||
pc|cK|pc|c5|pc|c2|pc|c7|pg||
pc|c3|pc|c8|pc|cA|pc|cT|pg||
mc|11|pg||
qx|c21|st||md|3ST7HQ942DJ7542CT7,SAJ9863HA8DA6CK63,SK5HKJ73DKQ93CJ85,SQ42HT65DT8CAQ942|sv|n|mb|1C|mb|p|mb|p|mb|d|mb|p|mb|p|mb|1D|mb|2S|mb|p|mb|4S|mb|p|mb|p|mb|p|pg||
pc|dK|pc|d8|pc|d7|pc|dA|pg||
pc|sA|pc|s5|pc|s2|pc|s7|pg||
pc|s3|pc|sK|pc|s4|pc|sT|pg||
pc|d3|pc|dT|pc|dJ|pc|d6|pg||
pc|h2|pc|hA|pc|h3|pc|h5|pg||
pc|c3|pc|c8|pc|cA|pc|c7|pg||
pc|c2|pc|cT|pc|cK|pc|c5|pg||
mc|11|pg||
qx|o22|st||md|4SJ8HKJ972DA9762CQ,SAQT72HT8DQ85C754,SK6HAQ643DKTCAKT8,S9543H5DJ43CJ9632|sv|e|mb|p|mb|1H|mb|1S|mb|2N!|mb|p|mb|3C!|mb|p|mb|3S!|mb|p|mb|3N!|mb|p|mb|4C!|mb|p|mb|4D!|mb|p|mb|4N!|mb|p|mb|5H!|mb|p|mb|6H|mb|p|mb|p|mb|p|pg||
pc|hT|pc|h3|pc|h5|pc|hJ|pg||
pc|h2|pc|h8|pc|hQ|pc|s3|pg||
pc|c8|pc|c2|pc|cQ|pc|c4|pg||
pc|d2|pc|d5|pc|dK|pc|d3|pg||
pc|cA|pc|c3|pc|s8|pc|c5|pg||
pc|cK|pc|c6|pc|sJ|pc|c7|pg||
pc|dT|pc|d4|pc|dA|pc|d8|pg||
mc|13|pg||
qx|c22|st||md|4SJ8HKJ972DA9762CQ,SAQT72HT8DQ85C754,SK6HAQ643DKTCAKT8,S9543H5DJ43CJ9632|sv|e|mb|p|mb|1H|mb|1S|mb|4N!|mb|p|mb|5H!|mb|p|mb|6H|mb|p|mb|p|mb|p|pg||
pc|sA|pc|s6|pc|s3|pc|s8|pg||
pc|s2|pc|sK|pc|s4|pc|sJ|pg||
mc|12|pg||
qx|o23|st||md|1SQ642HAKQT5D53C98,SA9873HJ92DAQTCJ4,SKH864DKJ964CAK63,SJT5H73D872CQT752|sv|b|mb|1H|mb|1S|mb|2S!|mb|p|mb|3H|mb|p|mb|4H|mb|p|mb|p|mb|p|pg||
pc|sA|pc|sK|pc|sJ|pc|s2|pg||
pc|c4|pc|cK|pc|c2|pc|c8|pg||
pc|h4|pc|h3|pc|hA|pc|h2|pg||
pc|s4|pc|s3|pc|h6|pc|s5|pg||
pc|cA|pc|c5|pc|c9|pc|cJ|pg||
pc|h8|pc|h7|pc|hK|pc|h9|pg||
pc|hQ|pc|hJ|pc|c3|pc|c7|pg||
pc|d3|pc|dA|pc|d4|pc|d2|pg||
pc|s9|pc|c6|pc|sT|pc|sQ|pg||
pc|hT|pc|s7|pc|d6|pc|cT|pg||
pc|h5|pc|dT|pc|d9|pc|cQ|pg||
pc|d5|pc|dQ|pc|dK|pc|d7|pg||
pc|dJ|pc|d8|pc|s6|pc|s8|pg||
pg||
qx|c23|st||md|1SQ642HAKQT5D53C98,SA9873HJ92DAQTCJ4,SKH864DKJ964CAK63,SJT5H73D872CQT752|sv|b|mb|1H|mb|1S|mb|2D|mb|p|mb|2H|mb|p|mb|4H|mb|p|mb|p|mb|p|pg||
pc|cJ|pc|cA|pc|c2|pc|c8|pg||
pc|h4|pc|h3|pc|hA|pc|h2|pg||
pc|d3|pc|dA|pc|d4|pc|d8|pg||
pc|c4|pc|cK|pc|c7|pc|c9|pg||
pc|sK|pc|sJ|pc|s2|pc|sA|pg||
pc|h9|pc|h6|pc|h7|pc|hT|pg||
pc|s4|pc|s3|pc|h8|pc|s5|pg||
pc|c6|pc|cQ|pc|hK|pc|s7|pg||
pc|hQ|pc|hJ|pc|d6|pc|c5|pg||
pc|h5|pc|s9|pc|c3|pc|d7|pg||
pc|sQ|pc|s8|pc|d9|pc|sT|pg||
pc|s6|pc|dT|pc|dJ|pc|d2|pg||
pc|d5|pc|dQ|pc|dK|pc|cT|pg||
pg||
qx|o24|st||md|2ST9HK6D942CA75432,SAHA542DQJ8CQJT98,SKQJ532HQT987DT7C,S8764HJ3DAK653CK6|sv|o|mb|1C|mb|2C!|mb|2D|mb|p|mb|3D|mb|3H|mb|4C|mb|p|mb|4H|mb|p|mb|5D|mb|p|mb|p|mb|p|pg||
pc|cA|pc|c8|pc|s2|pc|cK|pg||
pc|c2|pc|c9|pc|d7|pc|c6|pg||
pc|h7|pc|hJ|pc|hK|pc|hA|pg||
pc|dQ|pc|dT|pc|d3|pc|d2|pg||
pc|dJ|pc|h8|pc|d5|pc|d4|pg||
pc|cQ|pc|s3|pc|h3|pc|c3|pg||
pc|cJ|pc|s5|pc|s4|pc|c4|pg||
pc|cT|pc|sJ|pc|s6|pc|c5|pg||
pc|sA|pc|sQ|pc|s7|pc|s9|pg||
pc|h2|pc|h9|pc|d6|pc|h6|pg||
pc|s8|pc|sT|pc|d8|pc|sK|pg||
mc|11|pg||
qx|c24|st||md|2ST9HK6D942CA75432,SAHA542DQJ8CQJT98,SKQJ532HQT987DT7C,S8764HJ3DAK653CK6|sv|o|mb|1C!|mb|2C!|mb|2D|mb|p|mb|2H!|mb|2S|mb|p|mb|p|mb|3D|mb|p|mb|p|mb|3S|mb|p|mb|p|mb|4D|mb|p|mb|p|mb|p|pg||
pc|sT|pc|sA|pc|s2|pc|s4|pg||
pc|dQ|pc|d7|pc|d3|pc|d2|pg||
pc|c8|pc|dT|pc|cK|pc|c2|pg||
pc|hT|pc|hJ|pc|hK|pc|hA|pg||
pc|c9|pc|s3|pc|c6|pc|cA|pg||
pc|h6|pc|h2|pc|h7|pc|h3|pg||
pc|hQ|pc|dK|pc|c3|pc|h4|pg||
pc|dA|pc|d4|pc|d8|pc|s5|pg||
pc|d6|pc|d9|pc|dJ|mc|10|pg||
qx|o25|st||md|3S85HJ8DJT6432CJT8,S7HT953DQ9875CKQ7,SKT432HAK62DACA62,SAQJ96HQ74DKC9543|sv|e|mb|1C!|mb|1S|mb|p!|mb|p|mb|p|pg||
pc|hJ|pc|h3|pc|hK|pc|h4|pg||
pc|dA|pc|dK|pc|d2|pc|d5|pg||
pc|hA|pc|hQ|pc|h8|pc|h5|pg||
pc|h2|pc|h7|pc|s5|pc|h9|pg||
pc|cJ|pc|cK|pc|cA|pc|c3|pg||
pc|h6|pc|c4|pc|s8|pc|hT|pg||
pc|cT|pc|cQ|pc|c2|pc|c5|pg||
pc|dQ|pc|s2|pc|s6|pc|d3|pg||
pc|sA|pc|d4|pc|s7|pc|s3|pg||
pc|sQ|pc|d6|pc|d7|pc|s4|pg||
pc|c9|pc|c8|pc|c7|pc|c6|pg||
mc|5|pg||
qx|c25|st||md|3S85HJ8DJT6432CJT8,S7HT953DQ9875CKQ7,SKT432HAK62DACA62,SAQJ96HQ74DKC9543|sv|e|mb|1S|mb|p|mb|p|mb|p|pg||
pc|dK|pc|d2|pc|d5|pc|dA|pg||
pc|hK|pc|h7|pc|h8|pc|h3|pg||
pc|hA|pc|h4|pc|hJ|pc|h5|pg||
pc|h2|pc|hQ|pc|s5|pc|h9|pg||
pc|d3|pc|d7|pc|s2|pc|s6|pg||
pc|sA|pc|s8|pc|s7|pc|s3|pg||
pc|c4|pc|cJ|pc|cQ|pc|cA|pg||
pc|c2|pc|c3|pc|c8|pc|cK|pg||
pc|hT|pc|h6|pc|c5|pc|d4|pg||
pc|dQ|pc|sK|pc|c9|pc|d6|pg||
mc|6|pg||
qx|o26|st||md|4SK964H96DT5CQT742,SQT32HQJ4D94CA863,SJ87HAT72DQJ632CK,SA5HK853DAK87CJ95|sv|b|mb|1C!|mb|p|mb|1H|mb|p|mb|1N|mb|p|mb|3N|mb|p|mb|p|mb|p|pg||
pc|c2|pc|c3|pc|cK|pc|c5|pg||
pc|d2|pc|d7|pc|dT|pc|d4|pg||
pc|d5|pc|d9|pc|dJ|pc|dA|pg||
pc|h3|pc|h6|pc|hQ|pc|hA|pg||
pc|h7|pc|h5|pc|h9|pc|hJ|pg||
pc|s2|pc|s8|pc|sA|pc|s4|pg||
pc|s5|pc|s6|pc|sT|pc|sJ|pg||
pc|s7|pc|d8|pc|sK|pc|s3|pg||
pc|s9|pc|sQ|pc|d3|pc|cJ|pg||
pc|h4|pc|h2|pc|hK|pc|c4|pg||
pc|dK|pc|c7|pc|c6|pc|d6|pg||
pc|c9|pc|cT|pc|cA|pc|dQ|pg||
pc|c8|pc|hT|pc|h8|pc|cQ|pg||
pg||
qx|c26|st||md|4SK964H96DT5CQT742,SQT32HQJ4D94CA863,SJ87HAT72DQJ632CK,SA5HK853DAK87CJ95|sv|b|mb|1N|mb|p|mb|2C!|mb|p|mb|2H|mb|p|mb|2N|mb|p|mb|p|mb|p|pg||
pc|c4|pc|c3|pc|cK|pc|c5|pg||
pc|d3|pc|d8|pc|dT|pc|d4|pg||
pc|d5|pc|d9|pc|dJ|pc|dA|pg||
pc|cJ|pc|cQ|pc|cA|pc|h2|pg||
pc|c6|pc|s8|pc|c9|pc|cT|pg||
pc|s4|pc|sT|pc|sJ|pc|sA|pg||
pc|h3|pc|h6|pc|hQ|pc|hA|pg||
pc|d6|pc|dK|pc|s6|pc|s2|pg||
pc|h5|pc|h9|pc|hJ|pc|h7|pg||
pc|c8|pc|d2|pc|s5|pc|c2|pg||
pc|h4|pc|hT|pc|hK|pc|c7|pg||
pc|h8|pc|s9|pc|s3|pc|s7|pg||
pc|d7|pc|sK|pc|sQ|pc|dQ|pg||
pg||
qx|o27|st||md|1SKQJ43HK5D943CA93,ST76HQJ43DJTC8765,S92HA9DK8765CQJT2,SA85HT8762DAQ2CK4|sv|o|mb|1S|mb|p|mb|1N!|mb|p|mb|p|mb|p|pg||
pc|h6|pc|h5|pc|hJ|pc|hA|pg||
pc|s2|pc|s5|pc|sK|pc|s6|pg||
pc|s3|pc|s7|pc|s9|pc|sA|pg||
pc|dA|pc|d3|pc|dJ|pc|d5|pg||
pc|dQ|pc|d4|pc|dT|pc|dK|pg||
pc|cQ|pc|cK|pc|cA|pc|c5|pg||
pc|sQ|pc|sT|mc|11|pg||
qx|c27|st||md|1SKQJ43HK5D943CA93,ST76HQJ43DJTC8765,S92HA9DK8765CQJT2,SA85HT8762DAQ2CK4|sv|o|mb|1S|mb|p|mb|1N|mb|p|mb|p|mb|p|pg||
pc|h2|pc|hK|pc|h3|pc|h9|pg||
pc|sK|pc|s7|pc|s2|pc|s5|pg||
pc|sQ|pc|s6|pc|s9|pc|s8|pg||
pc|cA|pc|c5|pc|c2|pc|c4|pg||
pc|c3|pc|c6|pc|cT|pc|cK|pg||
pc|sA|pc|s3|pc|sT|pc|d5|pg||
pc|hT|pc|h5|pc|h4|pc|hA|pg||
pc|cQ|pc|d2|pc|c9|pc|c7|pg||
pc|cJ|pc|h6|pc|d3|pc|c8|pg||
pc|d6|pc|dQ|pc|d4|pc|dT|pg||
pc|h7|pc|d9|pc|hJ|pc|d7|pg||
pc|hQ|pc|d8|pc|h8|pc|s4|pg||
pc|dJ|pc|dK|pc|dA|pc|sJ|pg||
pg||
qx|o28|st||md|2SAQJ32H9DJT5CAKJ5,S94HJ852DQ982C962,SK765H743DA64C874,ST8HAKQT6DK73CQT3|sv|n|mb|p|mb|p|mb|1N|mb|2D!|mb|p|mb|2S|mb|d|mb|p|mb|2N!|mb|3S|mb|p|mb|4S|mb|p|mb|p|mb|p|pg||
pc|hK|pc|h9|pc|h2|pc|h3|pg||
pc|d3|pc|dJ|pc|dQ|pc|dA|pg||
pc|s5|pc|s8|pc|sA|pc|s4|pg||
pc|sQ|pc|s9|pc|sK|pc|sT|pg||
pc|c4|pc|c3|pc|cJ|pc|c2|pg||
pc|cA|pc|c6|pc|c7|pc|cT|pg||
pc|cK|pc|c9|pc|c8|pc|cQ|pg||
pc|c5|pc|h5|pc|d4|pc|h6|pg||
mc|11|pg||
qx|c28|st||md|2SAQJ32H9DJT5CAKJ5,S94HJ852DQ982C962,SK765H743DA64C874,ST8HAKQT6DK73CQT3|sv|n|mb|p|mb|p|mb|1H|mb|1S|mb|3H|mb|3S|mb|p|mb|4S|mb|p|mb|p|mb|p|pg||
pc|h5|pc|h3|pc|hQ|pc|h9|pg||
pc|cT|pc|cA|pc|c6|pc|c4|pg||
pc|sQ|pc|s4|pc|s5|pc|s8|pg||
pc|s2|pc|s9|pc|sK|pc|sT|pg||
pc|c7|pc|c3|pc|c5|pc|c9|pg||
pc|h2|pc|h4|pc|hK|pc|s3|pg||
pc|cK|pc|c2|pc|c8|pc|cQ|pg||
pc|cJ|pc|h8|pc|d4|pc|h6|pg||
mc|10|pg||
qx|o29|st||md|3SAQ63HT5DCJ987632,SKJ84HA63D9542C54,ST7HQ972DAQT3CAQT,S952HKJ84DKJ876CK|sv|b|mb|1N|mb|p|mb|2S!|mb|p|mb|2N!|mb|p|mb|3D!|mb|p|mb|3N|mb|p|mb|5C|mb|p|mb|p|mb|p|pg||
pc|s4|pc|s7|pc|s9|pc|sQ|pg||
pc|sA|pc|s8|pc|sT|pc|s2|pg||
pc|s3|pc|sJ|pc|cT|pc|s5|pg||
pc|dA|pc|d6|pc|h5|pc|d2|pg||
pc|d3|pc|d7|pc|c2|pc|d4|pg||
pc|s6|pc|sK|pc|cQ|pc|cK|pg||
pc|d8|pc|c3|pc|d5|pc|dT|pg||
pc|c6|pc|c4|pc|cA|pc|h4|pg||
pc|h2|pc|h8|pc|hT|pc|hA|pg||
mc|11|pg||
qx|c29|st||md|3SAQ63HT5DCJ987632,SKJ84HA63D9542C54,ST7HQ972DAQT3CAQT,S952HKJ84DKJ876CK|sv|b|mb|1C|mb|1D|mb|1S|mb|2C!|mb|p|mb|2D|mb|3C|mb|3D|mb|p|mb|p|mb|4C|mb|p|mb|p|mb|p|pg||
pc|d6|pc|h5|pc|d9|pc|dQ|pg||
pc|dA|pc|d7|pc|hT|pc|d2|pg||
pc|sT|pc|s9|pc|sQ|pc|sK|pg||
pc|c4|pc|cA|pc|cK|pc|c2|pg||
pc|s7|pc|s2|pc|sA|pc|s4|pg||
pc|s3|pc|s8|pc|cT|pc|s5|pg||
pc|h2|pc|h4|pc|c3|pc|h3|pg||
pc|s6|pc|sJ|pc|cQ|mc|12|pg||
qx|o30|st||md|4S7HJ32DKQT9862C94,S96543HQ975DCQT87,SKJHK864DA54CA653,SAQT82HATDJ73CKJ2|sv|o|mb|1S|mb|3D|mb|4S|mb|p|mb|p|mb|p|pg||
pc|dK|pc|s3|pc|d4|pc|d3|pg||
pc|s4|pc|sJ|pc|sQ|pc|s7|pg||
pc|sA|pc|d2|pc|s5|pc|sK|pg||
mc|12|pg||
qx|c30|st||md|4S7HJ32DKQT9862C94,S96543HQ975DCQT87,SKJHK864DA54CA653,SAQT82HATDJ73CKJ2|sv|o|mb|1N|mb|3D|mb|p|mb|3N|mb|p|mb|p|mb|p|pg||
pc|s2|pc|s7|pc|s9|pc|sJ|pg||
pc|dA|pc|d3|pc|d2|pc|c8|pg||
pc|d4|pc|dJ|pc|dK|pc|h5|pg||
pc|dQ|pc|s6|pc|d5|pc|d7|pg||
pc|dT|pc|s5|pc|h4|pc|s8|pg||
pc|d9|pc|s4|pc|h6|pc|c2|pg||
pc|d8|pc|s3|pc|c5|pc|hT|pg||
pc|d6|pc|c7|pc|c3|pc|cJ|pg||
pc|c4|pc|cT|pc|cA|pc|cK|pg||
mc|9|pg||
qx|o31|st||md|1SAK8643HAQT5D65C4,SQ7HKJ9643DAJCT62,SJ9H7DKT9CAKQJ975,ST52H82DQ87432C83|sv|n|mb|1S|mb|2H|mb|3C|mb|p|mb|3N|mb|p|mb|p|mb|p|pg||
pc|h6|pc|h7|pc|h8|pc|hT|pg||
pc|c4|pc|c2|pc|cA|pc|c3|pg||
pc|cK|pc|c8|pc|d6|pc|c6|pg||
pc|cQ|pc|d2|pc|d5|pc|cT|pg||
pc|cJ|pc|d3|pc|s3|pc|h4|pg||
pc|c9|pc|h2|pc|s4|pc|h3|pg||
pc|c7|pc|s2|pc|s6|pc|h9|pg||
pc|c5|pc|d4|pc|s8|pc|s7|pg||
pc|s9|pc|s5|pc|sA|pc|sQ|pg||
pc|sK|pc|dJ|pc|sJ|pc|sT|pg||
pc|hA|pc|hJ|pc|d9|pc|d7|pg||
mc|11|pg||
qx|c31|st||md|1SAK8643HAQT5D65C4,SQ7HKJ9643DAJCT62,SJ9H7DKT9CAKQJ975,ST52H82DQ87432C83|sv|n|mb|1S|mb|2H|mb|3C|mb|p|mb|3N|mb|p|mb|p|mb|p|pg||
pc|h4|pc|h7|pc|h8|pc|hT|pg||
pc|c4|pc|c2|pc|cA|pc|c3|pg||
pc|cK|pc|c8|pc|s3|pc|c6|pg||
pc|cQ|pc|d2|pc|s4|pc|cT|pg||
pc|cJ|pc|d3|pc|d5|pc|h3|pg||
pc|c9|pc|d4|pc|h5|pc|h6|pg||
pc|c7|pc|s5|pc|d6|pc|h9|pg||
pc|c5|pc|h2|pc|hQ|pc|dJ|pg||
pc|s9|pc|s2|pc|sA|pc|s7|pg||
pc|sK|pc|sQ|pc|sJ|pc|sT|pg||
mc|13|pg||
qx|o32|st||md|2SJ5HAKT4DA76CQ865,S876H8DQT983CA972,SKT4HJ765DK54CKT4,SAQ932HQ932DJ2CJ3|sv|e|mb|p|mb|p|mb|1S|mb|d|mb|2S!|mb|3H|mb|p|mb|p|mb|p|pg||
pc|sA|pc|s5|pc|s6|pc|s4|pg||
pc|cJ|pc|c5|pc|c2|pc|cK|pg||
pc|h5|pc|h2|pc|hA|pc|h8|pg||
pc|hK|pc|d8|pc|h6|pc|h3|pg||
pc|sJ|pc|s7|pc|sT|pc|sQ|pg||
pc|s2|pc|d6|pc|s8|pc|sK|pg||
pc|d4|pc|d2|pc|dA|pc|d3|pg||
pc|d7|pc|d9|pc|dK|pc|dJ|pg||
pc|d5|pc|s3|pc|h4|pc|dT|pg||
pc|c6|pc|c7|pc|cT|pc|c3|pg||
pc|c4|pc|s9|pc|c8|pc|c9|pg||
pc|cA|pc|hJ|pc|hQ|pc|cQ|pg||
pc|h9|pc|hT|pc|dQ|pc|h7|pg||
pg||
qx|c32|st||md|2SJ5HAKT4DA76CQ865,S876H8DQT983CA972,SKT4HJ765DK54CKT4,SAQ932HQ932DJ2CJ3|sv|e|mb|p|mb|p|mb|1S|mb|d|mb|2H!|mb|d|mb|2S|mb|p|mb|p|mb|3H|mb|p|mb|p|mb|p|pg||
pc|sA|pc|s5|pc|s8|pc|s4|pg||
pc|s3|pc|sJ|pc|s7|pc|sT|pg||
pc|hA|pc|h8|pc|h5|pc|h2|pg||
pc|dA|pc|d3|pc|d4|pc|d2|pg||
pc|d6|pc|d9|pc|dK|pc|dJ|pg||
pc|sK|pc|s2|pc|d7|pc|s6|pg||
pc|h6|pc|h3|pc|hT|pc|d8|pg||
pc|c5|pc|c2|pc|cK|pc|c3|pg||
pc|d5|pc|h9|pc|hK|pc|dT|pg||
pc|cQ|pc|cA|pc|c4|pc|cJ|pg||
mc|10|pg||