vg|41st WBTC-BBO2-BB,RR18,I,17,32,JAPAN,0,BRAZIL,0|
rs|2CE-1,2CE-1,3NS=,3NS=,4SN+2,4SS+2,1SNx-5,3NE+1,5DWx-4,4HN+1,2SE+2,3SE+1,3HW=,3HW=,5DSx-1,6CWx-1,3DS+1,3SN+1,1NE-3,2DEx-2,3NN+4,3NN+4,3NW-1,3NW=,4HW+1,4HW=,3NE=,3NE-1,7DW=,6DW+1,2DN-1,3NS=|
pn|TERAMOTO,TOMA,INO,BRENNER,VILLAS-BOA,TAKAYAMA,CAMPOS,KAKU|pg||
qx|o17|st||md|3ST86HKT65DJT7C986,SKQ7HA2DK9854CAQJ,SAJ54HQJ7DAQ2CK52,S932H9843D63CT743|sv|o|mb|1N|mb|p|mb|p|mb|d|mb|p|mb|2C|mb|p|mb|p|mb|p|pg||
pc|dJ|pc|d4|pc|d2|pc|d3|pg||
pc|c6|pc|cJ|pc|cK|pc|c3|pg||
pc|c2|pc|c4|pc|c8|pc|cA|pg||
pc|dK|pc|dA|pc|d6|pc|d7|pg||
pc|hQ|pc|h4|pc|h5|pc|h2|pg||
pc|h7|pc|h3|pc|h6|pc|hA|pg||
pc|d9|pc|dQ|pc|c7|pc|dT|pg||
pc|s3|pc|s8|pc|sK|pc|sA|pg||
pc|c5|pc|cT|pc|c9|pc|cQ|pg||
mc|7|pg||
qx|c17|st||md|3ST86HKT65DJT7C986,SKQ7HA2DK9854CAQJ,SAJ54HQJ7DAQ2CK52,S932H9843D63CT743|sv|o|mb|1N|mb|p|mb|p|mb|d|mb|p|mb|2C|mb|p|mb|p|mb|p|pg||
pc|dJ|pc|dK|pc|dA|pc|d3|pg||
pc|dQ|pc|d6|pc|d7|pc|d4|pg||
pc|d2|pc|s3|pc|dT|pc|d5|pg||
pc|s6|pc|sK|pc|sA|pc|s9|pg||
pc|sJ|pc|s2|pc|s8|pc|sQ|pg||
pc|cA|pc|c2|pc|c3|pc|c6|pg||
pc|cJ|pc|cK|pc|c4|pc|c8|pg||
pc|s5|pc|c7|pc|sT|pc|s7|pg||
pc|cT|pc|c9|pc|cQ|pc|c5|pg||
pc|d8|pc|h7|pc|h3|pc|h5|pg||
mc|7|pg||
qx|o18|st||md|4SAT2HQT3DA95CAT65,SK943HJ96DKJ62C93,SQ765HA52DQT84CK2,SJ8HK874D73CQJ874|sv|n|mb|p|mb|1N|mb|p|mb|2C|mb|p|mb|2D|mb|p|mb|3N|mb|p|mb|p|mb|p|pg||
pc|s4|pc|s5|pc|sJ|pc|sA|pg||
pc|sT|pc|s3|pc|s6|pc|s8|pg||
pc|s2|pc|sK|pc|s7|pc|c4|pg||
pc|h6|pc|h2|pc|hK|pc|h3|pg||
pc|h4|pc|hT|pc|hJ|pc|hA|pg||
pc|sQ|pc|h7|pc|c5|pc|s9|pg||
pc|d4|pc|d3|pc|d9|pc|dJ|pg||
pc|h9|pc|h5|pc|h8|pc|hQ|pg||
pc|dA|pc|d2|pc|d8|pc|d7|pg||
pc|d5|pc|dK|pc|dT|pc|c7|pg||
pc|d6|pc|dQ|pc|c8|pc|c6|pg||
pc|cK|pc|cJ|pc|cT|pc|c3|pg||
pc|c2|pc|cQ|pc|cA|pc|c9|pg||
pg||
qx|c18|st||md|4SAT2HQT3DA95CAT65,SK943HJ96DKJ62C93,SQ765HA52DQT84CK2,SJ8HK874D73CQJ874|sv|n|mb|p|mb|1N|mb|p|mb|2C|mb|p|mb|2D|mb|p|mb|3N|mb|p|mb|p|mb|p|pg||
pc|s3|pc|s5|pc|sJ|pc|sA|pg||
pc|sT|pc|sK|pc|s6|pc|s8|pg||
pc|h6|pc|h2|pc|hK|pc|h3|pg||
pc|h4|pc|hT|pc|hJ|pc|hA|pg||
pc|d4|pc|d7|pc|d9|pc|dJ|pg||
pc|h9|pc|h5|pc|h7|pc|hQ|pg||
pc|c5|pc|c3|pc|cK|pc|c4|pg||
pc|d8|pc|d3|pc|d5|pc|dK|pg||
pc|s4|pc|s7|pc|c7|pc|s2|pg||
pc|sQ|pc|c8|pc|dA|pc|s9|pg||
mc|9|pg||
qx|o19|st||md|1SKJT2H62D96CAKQJ5,S6HAQ3DKQJ52CT876,SAQ843HKT8DAT73C4,S975HJ9754D84C932|sv|e|mb|1C|mb|1D|mb|1S|mb|p|mb|3S|mb|p|mb|4C|mb|p|mb|4S|mb|p|mb|p|mb|p|pg||
pc|d8|pc|d6|pc|dJ|pc|dA|pg||
pc|s3|pc|s5|pc|sK|pc|s6|pg||
pc|s2|pc|d5|pc|sA|pc|s7|pg||
pc|s4|pc|s9|pc|sJ|pc|c6|pg||
pc|cA|pc|c7|pc|c4|pc|c3|pg||
pc|cK|pc|c8|pc|d3|pc|c2|pg||
pc|cQ|pc|cT|pc|d7|pc|c9|pg||
pc|cJ|pc|d2|pc|dT|pc|h4|pg||
pc|c5|pc|h3|pc|h8|pc|d4|pg||
pc|h6|pc|hA|pc|hT|pc|h5|pg||
pc|dK|pc|s8|pc|h7|pc|d9|pg||
pc|sQ|pc|h9|pc|sT|pc|dQ|pg||
pc|hK|pc|hJ|pc|h2|pc|hQ|pg||
pg||
qx|c19|st||md|1SKJT2H62D96CAKQJ5,S6HAQ3DKQJ52CT876,SAQ843HKT8DAT73C4,S975HJ9754D84C932|sv|e|mb|1C|mb|1D|mb|2H|mb|p|mb|3S|mb|p|mb|4D|mb|p|mb|4S|mb|p|mb|p|mb|p|pg||
pc|dK|pc|dA|pc|d4|pc|d6|pg||
pc|sA|pc|s5|pc|s2|pc|s6|pg||
pc|s3|pc|s7|pc|sT|pc|d2|pg||
pc|sK|pc|h3|pc|s4|pc|s9|pg||
pc|cA|pc|c6|pc|c4|pc|c3|pg||
pc|cK|pc|c7|pc|d3|pc|c2|pg||
pc|cQ|pc|c8|pc|d7|pc|c9|pg||
pc|cJ|pc|cT|pc|dT|pc|h7|pg||
pc|c5|pc|d5|pc|h8|pc|h4|pg||
pc|h2|pc|hA|pc|hT|pc|h5|pg||
mc|12|pg||
qx|o20|st||md|2S652HT64DT8764C73,S7HKQJ73DQ52CAKQ9,SKQ43HA98DKJ3C654,SAJT98H52DA9CJT82|sv|b|mb|1H|mb|d|mb|r|mb|p|mb|p|mb|1S|mb|d|mb|p|mb|p|mb|p|pg||
pc|h5|pc|h4|pc|hJ|pc|hA|pg||
pc|c6|pc|c8|pc|c3|pc|cQ|pg||
pc|s7|pc|sK|pc|sA|pc|s2|pg||
pc|sJ|pc|s5|pc|h3|pc|sQ|pg||
pc|c5|pc|cT|pc|c7|pc|c9|pg||
pc|s8|pc|s6|pc|d5|pc|s3|pg||
pc|sT|pc|d4|pc|d2|pc|s4|pg||
pc|h2|pc|h6|pc|hK|pc|h8|pg||
pc|hQ|pc|h9|pc|d9|pc|hT|pg||
pc|h7|pc|d3|pc|c2|pc|d6|pg||
pc|cA|pc|c4|pc|cJ|pc|d7|pg||
pc|cK|pc|dJ|pc|dA|pc|d8|pg||
pc|dQ|pc|dK|pc|s9|pc|dT|pg||
pg||
qx|c20|st||md|2S652HT64DT8764C73,S7HKQJ73DQ52CAKQ9,SKQ43HA98DKJ3C654,SAJT98H52DA9CJT82|sv|b|mb|1H|mb|d|mb|r|mb|p|mb|p|mb|1S|mb|d|mb|p|mb|2S|mb|p|mb|2N|mb|p|mb|3N|mb|p|mb|p|mb|p|pg||
pc|d6|pc|d2|pc|dJ|pc|dA|pg||
pc|h5|pc|hT|pc|hK|pc|hA|pg||
pc|sK|pc|sA|pc|s5|pc|s7|pg||
pc|sJ|pc|s2|pc|h3|pc|s4|pg||
pc|sT|pc|s6|pc|h7|pc|sQ|pg||
pc|dK|pc|d9|pc|d4|pc|d5|pg||
mc|10|pg||
qx|o21|st||md|3SAJ32HAKT73D73C97,S87H9DAQJT54CQT86,S654HJ8542DK2CAKJ,SKQT9HQ6D986C5432|sv|n|mb|1H|mb|p|mb|3N|mb|4D|mb|4H|mb|5D|mb|p|mb|p|mb|d|mb|p|mb|p|mb|p|pg||
pc|cK|pc|c2|pc|c7|pc|c8|pg||
pc|h2|pc|hQ|pc|hK|pc|h9|pg||
pc|c9|pc|cT|pc|cJ|pc|c3|pg||
pc|cA|pc|c4|pc|h3|pc|c6|pg||
pc|hJ|pc|h6|pc|hT|pc|dT|pg||
pc|s8|pc|s6|pc|sK|pc|sA|pg||
pc|d3|pc|d4|pc|dK|pc|d6|pg||
mc|7|pg||
qx|c21|st||md|3SAJ32HAKT73D73C97,S87H9DAQJT54CQT86,S654HJ8542DK2CAKJ,SKQT9HQ6D986C5432|sv|n|mb|1H|mb|p|mb|2N|mb|3D|mb|p|mb|3S|mb|4H|mb|p|mb|p|mb|p|pg||
pc|d6|pc|d3|pc|dA|pc|d2|pg||
pc|cT|pc|cA|pc|c3|pc|c7|pg||
pc|h4|pc|h6|pc|hA|pc|h9|pg||
pc|hK|pc|d4|pc|h2|pc|hQ|pg||
pc|c9|pc|c6|pc|cK|pc|c2|pg||
pc|cJ|pc|c4|pc|h3|pc|c8|pg||
pc|d7|pc|dQ|pc|dK|pc|d8|pg||
pc|s4|pc|sK|pc|sA|pc|s7|pg||
pc|h7|pc|d5|pc|hJ|pc|c5|pg||
pc|s5|mc|11|pg||
qx|o22|st||md|4S32H975DT653CAK76,SKQ65HK864DK9C982,SJ74HQJT32DAQJ2CT,SAT98HAD874CQJ543|sv|e|mb|1C|mb|p|mb|1H|mb|p|mb|1S|mb|p|mb|2C|mb|p|mb|2D|mb|p|mb|2S|mb|p|mb|p|mb|p|pg||
pc|cA|pc|c2|pc|cT|pc|c4|pg||
pc|d5|pc|dK|pc|dA|pc|d8|pg||
pc|s4|pc|s8|pc|s2|pc|s5|pg||
pc|s9|pc|s3|pc|sK|pc|s7|pg||
pc|s6|pc|sJ|pc|sA|pc|h7|pg||
pc|c3|pc|c7|pc|c8|pc|h2|pg||
pc|c9|pc|dQ|pc|cQ|pc|cK|pg||
pc|h9|pc|h4|pc|hT|pc|hA|pg||
pc|cJ|pc|c6|pc|d9|pc|h3|pg||
pc|c5|pc|d3|pc|h6|pc|d2|pg||
pc|d4|pc|d6|pc|sQ|pc|dJ|pg||
pc|hK|pc|hJ|pc|d7|pc|h5|pg||
pc|h8|pc|hQ|pc|sT|pc|dT|pg||
pg||
qx|c22|st||md|4S32H975DT653CAK76,SKQ65HK864DK9C982,SJ74HQJT32DAQJ2CT,SAT98HAD874CQJ543|sv|e|mb|1C|mb|p|mb|1H|mb|p|mb|1S|mb|p|mb|3S|mb|p|mb|p|mb|p|pg||
pc|cA|pc|c2|pc|cT|pc|c4|pg||
pc|cK|pc|c8|pc|h3|pc|c3|pg||
pc|c6|pc|c9|pc|s7|pc|cJ|pg||
pc|hT|pc|hA|pc|h7|pc|h4|pg||
pc|s8|pc|s2|pc|sK|pc|s4|pg||
pc|sQ|pc|sJ|pc|s9|pc|s3|pg||
pc|hK|pc|h2|pc|d4|pc|h5|pg||
pc|h6|pc|hQ|pc|sT|pc|h9|pg||
pc|cQ|pc|c7|pc|d9|mc|10|pg||
qx|o23|st||md|1SQ2H5DT853CAK7632,SKJ6HKJ86432DJ2CQ,ST83HAT97DA4CJT98,SA9754HQDKQ976C54|sv|b|mb|p|mb|3H|mb|p|mb|p|mb|p|pg||
pc|cJ|pc|c4|pc|cK|pc|cQ|pg||
pc|s2|pc|s6|pc|sT|pc|sA|pg||
pc|hQ|pc|h5|pc|h2|pc|hA|pg||
pc|s8|pc|s4|pc|sQ|pc|sK|pg||
pc|hK|pc|h7|pc|c5|pc|c2|pg||
pc|hJ|pc|h9|pc|d6|pc|c3|pg||
pc|sJ|pc|s3|pc|s5|pc|c6|pg||
pc|h3|pc|hT|pc|d7|pc|d3|pg||
mc|9|pg||
qx|c23|st||md|1SQ2H5DT853CAK7632,SKJ6HKJ86432DJ2CQ,ST83HAT97DA4CJT98,SA9754HQDKQ976C54|sv|b|mb|p|mb|1H|mb|p|mb|1S|mb|2C|mb|2H|mb|3C|mb|d|mb|p|mb|3H|mb|p|mb|p|mb|p|pg||
pc|cJ|pc|c4|pc|cK|pc|cQ|pg||
pc|cA|pc|h2|pc|c8|pc|c5|pg||
pc|h3|pc|h7|pc|hQ|pc|h5|pg||
pc|dK|pc|d3|pc|d2|pc|d4|pg||
pc|d6|pc|d5|pc|dJ|pc|dA|pg||
pc|cT|pc|s4|pc|c7|pc|h4|pg||
pc|hK|pc|hA|pc|s5|pc|c6|pg||
pc|s3|pc|s7|pc|sQ|pc|sK|pg||
pc|hJ|pc|h9|pc|d7|pc|c2|pg||
mc|9|pg||
qx|o24|st||md|2SAQ52H54DKJT874C3,S9HKQJ6DA63CAQJ65,SK8763HAT72DQ52C9,SJT4H983D9CKT8742|sv|o|mb|1C|mb|1S|mb|3C|mb|4D|mb|4H|mb|4S|mb|5C|mb|p|mb|p|mb|5D|mb|p|mb|p|mb|d|mb|p|mb|p|mb|p|pg||
pc|hK|pc|hA|pc|h9|pc|h5|pg||
pc|d2|pc|d9|pc|dJ|pc|dA|pg||
pc|hQ|pc|h2|pc|h3|pc|h4|pg||
pc|cA|pc|c9|pc|c7|pc|c3|pg||
pc|d3|pc|d5|pc|c2|pc|d7|pg||
pc|d4|pc|d6|pc|dQ|pc|c4|pg||
pc|h7|pc|h8|pc|d8|pc|h6|pg||
pc|dK|pc|c5|pc|s3|pc|c8|pg||
pc|sA|pc|s9|pc|s6|pc|s4|pg||
mc|10|pg||
qx|c24|st||md|2SAQ52H54DKJT874C3,S9HKQJ6DA63CAQJ65,SK8763HAT72DQ52C9,SJT4H983D9CKT8742|sv|o|mb|1C|mb|1S|mb|2C|mb|4D|an|fit show|mb|4H|mb|p|mb|5C|mb|p|mb|p|mb|5D|mb|p|mb|p|mb|d|mb|p|mb|6C|mb|d|mb|p|mb|p|mb|p|pg||
pc|s3|pc|s4|pc|sA|pc|s9|pg||
pc|dJ|pc|dA|pc|d5|pc|d9|pg||
pc|cA|pc|c9|pc|c4|pc|c3|pg||
pc|hK|pc|hA|pc|h3|pc|h5|pg||
mc|11|pg||
qx|o25|st||md|3SAQ7HAT863D8632CA,SK953HJ5DAK4CK974,SJT862HKDQT95CJT2,S4HQ9742DJ7CQ8653|sv|e|mb|p|mb|p|mb|1H|mb|d|mb|1S|mb|2C|mb|d|mb|p|mb|2S|mb|p|mb|p|mb|3C|mb|p|mb|p|mb|3D|mb|p|mb|p|mb|p|pg||
pc|c7|pc|cJ|pc|c6|pc|cA|pg||
pc|d2|pc|dK|pc|d5|pc|d7|pg||
pc|cK|pc|c2|pc|c3|pc|d3|pg||
pc|d6|pc|dA|pc|d9|pc|dJ|pg||
pc|d4|pc|dT|pc|h4|pc|d8|pg||
pc|hK|pc|h2|pc|h3|pc|h5|pg||
pc|s2|pc|s4|pc|sA|pc|s3|pg||
pc|hA|pc|hJ|pc|cT|pc|h7|pg||
pc|sQ|pc|sK|pc|s6|pc|c5|pg||
mc|10|pg||
qx|c25|st||md|3SAQ7HAT863D8632CA,SK953HJ5DAK4CK974,SJT862HKDQT95CJT2,S4HQ9742DJ7CQ8653|sv|e|mb|p|mb|p|mb|1H|mb|d|mb|p|mb|2C|mb|d|mb|p|mb|3S|mb|p|mb|p|mb|p|pg||
pc|dJ|pc|d2|pc|dK|pc|dQ|pg||
pc|dA|pc|d5|pc|d7|pc|d3|pg||
pc|s3|pc|s2|pc|s4|pc|s7|pg||
pc|cA|pc|c4|pc|c2|pc|c3|pg||
pc|h3|pc|h5|pc|hK|pc|h4|pg||
pc|cT|pc|c5|pc|sQ|pc|c7|pg||
pc|sA|pc|s5|pc|s6|pc|h2|pg||
pc|hA|pc|hJ|pc|cJ|pc|h7|pg||
pc|d6|pc|d4|pc|d9|pc|c6|pg||
pc|sT|pc|c8|pc|h6|pc|sK|pg||
mc|10|pg||
qx|o26|st||md|4ST52HT8764DQCAQ74,SJ643H93DJ865CT32,SAK7HQ5DKT32CKJ98,SQ98HAKJ2DA974C65|sv|b|mb|1N|mb|p|mb|p|mb|p|pg||
pc|h6|pc|h9|pc|hQ|pc|hA|pg||
pc|d9|pc|dQ|pc|d5|pc|d2|pg||
pc|hT|pc|h3|pc|h5|pc|hJ|pg||
pc|dA|pc|s2|pc|d6|pc|d3|pg||
pc|hK|pc|h4|pc|c2|pc|s7|pg||
pc|h2|pc|h7|pc|s3|pc|dT|pg||
pc|h8|pc|s4|pc|c8|pc|d4|pg||
pc|sT|pc|s6|pc|sK|pc|s8|pg||
pc|cJ|pc|c5|pc|c4|pc|c3|pg||
pc|c9|pc|c6|pc|cQ|pc|cT|pg||
pc|cA|pc|sJ|pc|cK|pc|d7|pg||
pc|c7|pc|d8|pc|dK|pc|s9|pg||
pc|s5|pc|dJ|pc|sA|pc|sQ|pg||
pg||
qx|c26|st||md|4ST52HT8764DQCAQ74,SJ643H93DJ865CT32,SAK7HQ5DKT32CKJ98,SQ98HAKJ2DA974C65|sv|b|mb|1D|mb|p|mb|p|mb|d|mb|1H|mb|d|mb|2D|mb|d|mb|p|mb|p|mb|p|pg||
pc|dQ|pc|d5|pc|d2|pc|d4|pg||
pc|s2|pc|s3|pc|sK|pc|s8|pg||
pc|cJ|pc|c6|pc|c4|pc|c2|pg||
pc|h5|pc|hK|pc|h8|pc|h3|pg||
pc|sQ|pc|s5|pc|s4|pc|s7|pg||
pc|s9|pc|sT|pc|sJ|pc|sA|pg||
pc|c8|pc|c5|pc|cQ|pc|c3|pg||
pc|cA|pc|cT|pc|cK|pc|d7|pg||
pc|hA|pc|h4|pc|h9|pc|hQ|pg||
pc|hJ|pc|h6|pc|s6|pc|d3|pg||
pc|c9|pc|h2|pc|c7|pc|d6|pg||
pc|d8|pc|dT|pc|dA|pc|h7|pg||
pc|d9|pc|hT|pc|dJ|pc|dK|pg||
pg||
qx|o27|st||md|1ST52HA3DQT9CKJ732,SQ763HK862DK752CQ,SAKJ4H94DAJ86CA95,S98HQJT75D43CT864|sv|o|mb|p|mb|p|mb|1N|mb|p|mb|3N|mb|p|mb|p|mb|p|pg||
pc|hQ|pc|hA|pc|h2|pc|h4|pg||
pc|dQ|pc|dK|pc|dA|pc|d3|pg||
pc|d6|pc|d4|pc|d9|pc|d2|pg||
pc|dT|pc|d5|pc|d8|pc|s8|pg||
pc|sT|pc|s3|pc|sK|pc|s9|pg||
pc|dJ|pc|c4|pc|h3|pc|d7|pg||
pc|cA|pc|c6|pc|c2|pc|cQ|pg||
pc|c9|pc|cT|pc|cK|pc|h6|pg||
pc|cJ|pc|s6|pc|c5|pc|c8|pg||
pc|c3|pc|h8|pc|s4|pc|h5|pg||
pc|c7|pc|hK|pc|h9|pc|h7|pg||
pc|s2|pc|s7|pc|sJ|pc|hT|pg||
pc|sA|pc|hJ|pc|s5|pc|sQ|pg||
pg||
qx|c27|st||md|1ST52HA3DQT9CKJ732,SQ763HK862DK752CQ,SAKJ4H94DAJ86CA95,S98HQJT75D43CT864|sv|o|mb|p|mb|p|mb|1N|mb|p|mb|3N|mb|p|mb|p|mb|p|pg||
pc|hQ|pc|hA|pc|h2|pc|h4|pg||
pc|c2|pc|cQ|pc|cA|pc|c4|pg||
pc|c9|pc|c6|pc|c3|pc|s3|pg||
pc|c5|pc|c8|pc|cJ|pc|d2|pg||
pc|cK|pc|d5|pc|h9|pc|cT|pg||
pc|c7|pc|h6|pc|d6|pc|d4|pg||
pc|dQ|pc|dK|pc|dA|pc|d3|pg||
pc|sA|pc|s8|pc|s2|pc|s6|pg||
pc|dJ|pc|h5|pc|d9|pc|d7|pg||
pc|d8|pc|h7|pc|dT|pc|hK|pg||
pc|sT|pc|s7|pc|s4|pc|s9|pg||
pc|s5|pc|sQ|pc|sK|pc|hT|pg||
pc|sJ|pc|hJ|pc|h3|pc|h8|pg||
pg||
qx|o28|st||md|2SK74HQT3DT98632CJ,SJ96HAJ7DAK74C843,SQT5HK982DJ5CKT52,SA832H654DQCAQ976|sv|n|mb|1D|mb|p|mb|2C|mb|p|mb|2N|mb|p|mb|3C|mb|p|mb|3N|mb|p|mb|p|mb|p|pg||
pc|h2|pc|h4|pc|hQ|pc|hA|pg||
pc|c3|pc|c2|pc|cQ|pc|cJ|pg||
pc|c6|pc|d6|pc|c4|pc|cT|pg||
pc|s5|pc|s2|pc|sK|pc|s6|pg||
pc|hT|pc|hJ|pc|hK|pc|h5|pg||
pc|h9|pc|h6|pc|h3|pc|h7|pg||
pc|h8|pc|s3|pc|s4|pc|d4|pg||
pc|d5|pc|dQ|pc|d3|pc|dA|pg||
mc|8|pg||
qx|c28|st||md|2SK74HQT3DT98632CJ,SJ96HAJ7DAK74C843,SQT5HK982DJ5CKT52,SA832H654DQCAQ976|sv|n|mb|1D|mb|p|mb|1S|mb|p|mb|1N|mb|p|mb|3N|mb|p|mb|p|mb|p|pg||
pc|c2|pc|cQ|pc|cJ|pc|c4|pg||
pc|dQ|pc|d2|pc|d4|pc|d5|pg||
pc|c6|pc|dT|pc|c3|pc|c5|pg||
pc|cA|pc|hT|pc|c8|pc|cT|pg||
pc|c7|pc|s4|pc|h7|pc|cK|pg||
pc|s5|pc|s2|pc|sK|pc|s6|pg||
pc|hQ|pc|hA|pc|h2|pc|h4|pg||
pc|dA|pc|dJ|pc|h5|pc|d3|pg||
pc|dK|pc|h8|pc|s3|pc|d6|pg||
pc|sJ|pc|sQ|pc|sA|pc|s7|pg||
pc|c9|mc|9|pg||
qx|o29|st||md|3SQ6H72DQJ7CA97532,S872HKQJT6DAT54CQ,SAJT954H843D3CT86,SK3HA95DK9862CKJ4|sv|b|mb|2D|mb|d|mb|2H|mb|d|mb|2S|mb|p|mb|p|mb|4H|mb|p|mb|p|mb|p|pg||
pc|d3|pc|d2|pc|dJ|pc|dA|pg||
pc|h6|pc|h4|pc|h9|pc|h2|pg||
pc|hA|pc|h7|pc|hT|pc|h3|pg||
pc|h5|pc|c5|pc|hK|pc|h8|pg||
pc|cQ|pc|c8|pc|c4|pc|c7|pg||
pc|dT|pc|s5|pc|d6|pc|dQ|pg||
pc|d7|pc|d4|pc|s9|pc|d9|pg||
pc|dK|pc|c2|pc|d5|pc|s4|pg||
pc|d8|pc|c3|pc|s2|pc|c6|pg||
pc|cK|pc|cA|pc|hJ|pc|cT|pg||
pc|s7|pc|sA|pc|s3|pc|s6|pg||
pc|sT|pc|sK|pc|sQ|pc|s8|pg||
pc|cJ|pc|c9|pc|hQ|pc|sJ|pg||
pg||
qx|c29|st||md|3SQ6H72DQJ7CA97532,S872HKQJT6DAT54CQ,SAJT954H843D3CT86,SK3HA95DK9862CKJ4|sv|b|mb|2S|mb|d|mb|3S|mb|4H|mb|p|mb|p|mb|p|pg||
pc|d3|pc|d2|pc|dJ|pc|dA|pg||
pc|hK|pc|h3|pc|h5|pc|h2|pg||
pc|hT|pc|h4|pc|hA|pc|h7|pg||
pc|c4|pc|cA|pc|cQ|pc|c8|pg||
pc|c2|pc|s8|pc|c6|pc|cJ|pg||
pc|h9|pc|c3|pc|hQ|pc|h8|pg||
pc|d5|pc|s4|pc|d9|pc|dQ|pg||
pc|s6|pc|s2|pc|sA|pc|s3|pg||
mc|10|pg||
qx|o30|st||md|4SAJ93H9DT65CQ9853,S652HT875DAJ7CJT7,ST7HQ632DQ432CK64,SKQ84HAKJ4DK98CA2|sv|o|mb|2N|mb|p|mb|3N|mb|p|mb|p|mb|p|pg||
pc|c5|pc|cJ|pc|cK|pc|cA|pg||
pc|hK|pc|h9|pc|h5|pc|h3|pg||
pc|c2|pc|cQ|pc|c7|pc|c4|pg||
pc|s3|pc|s2|pc|sT|pc|sK|pg||
pc|d9|pc|d6|pc|dJ|pc|dQ|pg||
pc|s7|pc|s8|pc|s9|pc|s5|pg||
pc|sA|pc|s6|pc|c6|pc|s4|pg||
pc|d5|pc|d7|pc|d3|pc|dK|pg||
pc|sQ|pc|sJ|pc|h7|pc|h2|pg||
pc|d8|pc|dT|pc|dA|pc|d2|pg||
pc|cT|pc|d4|pc|hJ|pc|c3|pg||
pc|h8|pc|h6|pc|h4|pc|c8|pg||
pc|hT|pc|hQ|pc|hA|pc|c9|pg||
pg||
qx|c30|st||md|4SAJ93H9DT65CQ9853,S652HT875DAJ7CJT7,ST7HQ632DQ432CK64,SKQ84HAKJ4DK98CA2|sv|o|mb|2N|mb|p|mb|3N|mb|p|mb|p|mb|p|pg||
pc|s3|pc|s2|pc|sT|pc|sQ|pg||
pc|hA|pc|h9|pc|h5|pc|h2|pg||
pc|d8|pc|d5|pc|dJ|pc|dQ|pg||
pc|s7|pc|s8|pc|s9|pc|s5|pg||
pc|d6|pc|dA|pc|d4|pc|d9|pg||
pc|h7|pc|h6|pc|h4|pc|c5|pg||
pc|h8|pc|h3|pc|hJ|pc|c3|pg||
pc|cA|pc|c8|pc|c7|pc|c4|pg||
pc|hK|pc|dT|pc|hT|pc|hQ|pg||
pc|dK|pc|sJ|pc|d7|pc|d2|pg||
pc|s4|pc|sA|pc|s6|pc|c6|pg||
pc|c9|pc|cT|pc|cK|pc|c2|pg||
pc|d3|pc|sK|pc|cQ|pc|cJ|pg||
pg||
qx|o31|st||md|1SKJH6432DJ86CQ987,S86HAQJ9DAKT9742C,SQT954HT87D53C542,SA732HK5DQCAKJT63|sv|n|mb|p|mb|1D|mb|p|mb|2C|mb|p|mb|2H|mb|p|mb|3C|mb|p|mb|3D|mb|p|mb|3S|mb|p|mb|4D|mb|p|mb|4N|mb|p|mb|5C|mb|p|mb|7D|mb|p|mb|p|mb|p|pg||
pc|sT|pc|sA|pc|sJ|pc|s8|pg||
pc|dQ|pc|d6|pc|d2|pc|d3|pg||
pc|c3|pc|c7|pc|d9|pc|c4|pg||
pc|dA|pc|d5|pc|s2|pc|d8|pg||
pc|dK|pc|c2|pc|s3|pc|dJ|pg||
mc|13|pg||
qx|c31|st||md|1SKJH6432DJ86CQ987,S86HAQJ9DAKT9742C,SQT954HT87D53C542,SA732HK5DQCAKJT63|sv|n|mb|p|mb|1D|mb|p|mb|2C|mb|p|mb|2D|mb|p|mb|2S|mb|p|mb|3D|mb|p|mb|4D|mb|p|mb|4H|mb|p|mb|4S|mb|d|mb|p|mb|p|mb|r|mb|p|mb|4N|mb|p|mb|5S|mb|p|mb|5N|mb|p|mb|6C|mb|p|mb|6D|mb|p|mb|p|mb|p|pg||
pc|sT|pc|sA|pc|sJ|pc|s8|pg||
pc|dQ|pc|d6|pc|d2|pc|d3|pg||
pc|cA|pc|c8|pc|s6|pc|c2|pg||
pc|s2|pc|sK|pc|d9|pc|s4|pg||
pc|dA|pc|d5|pc|c3|pc|d8|pg||
pc|dK|mc|13|pg||
qx|o32|st||md|2SQ32HQJ82DKT4CQJ3,S65H7DQ8532CT8752,SJ984HKT95DAJ9CA9,SAKT7HA643D76CK64|sv|e|mb|p|mb|1D|mb|d|mb|r|mb|2C|mb|p|mb|p|mb|2D|mb|p|mb|p|mb|p|pg||
pc|sA|pc|s2|pc|s5|pc|s8|pg||
pc|h3|pc|hQ|pc|h7|pc|h9|pg||
pc|d4|pc|d2|pc|dJ|pc|d6|pg||
pc|s4|pc|sK|pc|s3|pc|s6|pg||
pc|s7|pc|sQ|pc|d3|pc|s9|pg||
pc|c2|pc|c9|pc|cK|pc|c3|pg||
pc|hA|pc|h2|pc|c5|pc|h5|pg||
pc|h6|pc|h8|pc|d5|pc|hK|pg||
pc|c7|pc|cA|pc|c4|pc|cJ|pg||
pc|d9|pc|d7|pc|dK|pc|d8|pg||
pc|dT|pc|dQ|pc|dA|pc|c6|pg||
pc|sJ|pc|sT|pc|cQ|pc|c8|pg||
pc|hT|pc|h4|pc|hJ|pc|cT|pg||
pg||
qx|c32|st||md|2SQ32HQJ82DKT4CQJ3,S65H7DQ8532CT8752,SJ984HKT95DAJ9CA9,SAKT7HA643D76CK64|sv|e|mb|p|mb|1D|mb|d|mb|p|mb|2C|mb|p|mb|p|mb|2N|mb|p|mb|3C|mb|p|mb|3N|mb|p|mb|p|mb|p|pg||
pc|c5|pc|c9|pc|cK|pc|c3|pg||
pc|c4|pc|cJ|pc|c2|pc|cA|pg||
pc|s4|pc|s7|pc|sQ|pc|s5|pg||
pc|h2|pc|h7|pc|hT|pc|hA|pg||
pc|sA|pc|s2|pc|s6|pc|s8|pg||
pc|c6|pc|cQ|pc|c8|pc|s9|pg||
pc|h8|pc|d2|pc|hK|pc|h3|pg||
pc|h5|pc|h4|pc|hJ|pc|c7|pg||
pc|hQ|pc|d3|pc|h9|pc|h6|pg||
pc|dK|pc|d5|pc|d9|pc|d6|pg||
pc|d4|pc|d8|pc|dJ|pc|d7|pg||
pc|dA|pc|sT|pc|dT|pc|dQ|pg||
pc|sJ|pc|sK|pc|s3|pc|cT|pg||
pg||