vg|41st WBTC-BBO5-BB,RR19,I,1,16,BRAZIL,0,NETHERLANDS,0|
rs|3NN=,1NN+2,6CNx-2,6CS-2,6DNx-4,6CW-1,5CS-1,3NS+1,3NN=,3NN-1,5CS-3,2HN=,2DW+2,1NE+2,3DN=,3DN=,1NN+1,1HN=,1NE+2,1NE=,3HS-1,3SE-2,5HE+1,3SSx-4,3NN-1,1NWx-2,4DSx-3,5DSx-2,4SW=,4SW+1,3NE-2,4HSx-2|
pn|BRUM,DE WIJS,CHAGAS,MULLER,VERHEES Jr,CAMPOS,VAN PROOIJ,VILLAS-BOA|pg||
qx|o1|st||md|3S943HQ2DJT73CQ652,SQJ52H8543DK54CK3,ST8HAKTDAQ962CAJ8,SAK76HJ976D8CT974|sv|o|mb|2N|mb|p|mb|3N|mb|p|mb|p|mb|p|pg||
pc|sA|pc|s3|pc|s2|pc|s8|pg||
pc|s6|pc|s4|pc|sJ|pc|sT|pg||
pc|s5|pc|c8|pc|sK|pc|s9|pg||
pc|s7|pc|d3|pc|sQ|pc|cJ|pg||
pc|c3|pc|cA|pc|c4|pc|c2|pg||
pc|hT|pc|h6|pc|hQ|pc|h3|pg||
pc|dJ|pc|d4|pc|d2|pc|d8|pg||
pc|dT|mc|9|pg||
qx|c1|st||md|3S943HQ2DJT73CQ652,SQJ52H8543DK54CK3,ST8HAKTDAQ962CAJ8,SAK76HJ976D8CT974|sv|o|mb|1C!|mb|p|mb|1D!|mb|p|mb|1N|mb|p|mb|p|mb|p|pg||
pc|h6|pc|hQ|pc|h8|pc|hT|pg||
pc|dJ|pc|d5|pc|d2|pc|d8|pg||
pc|dT|pc|dK|pc|dA|pc|s6|pg||
pc|dQ|pc|h7|pc|d3|pc|d4|pg||
pc|d9|pc|c4|pc|d7|pc|h5|pg||
pc|d6|pc|h9|pc|s3|pc|h4|pg||
pc|hA|pc|hJ|pc|h2|pc|h3|pg||
pc|hK|pc|c7|pc|s4|pc|s2|pg||
pc|cA|pc|c9|pc|c2|pc|c3|pg||
pc|c8|pc|cT|pc|cQ|pc|cK|pg||
pc|s5|pc|s8|pc|sA|pc|s9|pg||
pc|sK|pc|c5|pc|sJ|pc|sT|pg||
pc|s7|pc|c6|pc|sQ|pc|cJ|pg||
pg||
qx|o2|st||md|4SAT6HK52DAQ8CA965,SQ874HQT973DCT742,SK32H6DK7543CKQJ3,SJ95HAJ84DJT962C8|sv|n|mb|p|mb|1N|mb|2C|an| |mb|3C|an| |mb|3H|mb|3N|mb|4H|mb|4N|mb|p|mb|5C|mb|p|mb|5D|mb|d|mb|p|mb|p|mb|6C|mb|p|mb|p|mb|d|mb|p|mb|p|mb|p|pg||
pc|d2|pc|d8|pc|c2|pc|d3|pg||
pc|hT|pc|h6|pc|hA|pc|h2|pg||
pc|d6|pc|dQ|pc|c4|pc|d4|pg||
mc|10|pg||
qx|c2|st||md|4SAT6HK52DAQ8CA965,SQ874HQT973DCT742,SK32H6DK7543CKQJ3,SJ95HAJ84DJT962C8|sv|n|mb|p|mb|1C!|mb|1H|mb|2C!|mb|4H|mb|p|mb|p|mb|5C|mb|p|mb|6C|mb|p|mb|p|mb|p|pg||
pc|h9|pc|h6|pc|hA|pc|h5|pg||
pc|d2|pc|dA|pc|c2|pc|d3|pg||
pc|c4|pc|cK|pc|c8|pc|c5|pg||
pc|cQ|pc|h4|pc|c6|pc|c7|pg||
pc|c3|pc|h8|pc|cA|pc|cT|pg||
pc|dQ|pc|h3|pc|d4|pc|d6|pg||
pc|d8|pc|h7|pc|dK|pc|d9|pg||
pc|d5|pc|dT|pc|c9|pc|s4|pg||
pc|hK|pc|hT|pc|s2|pc|hJ|pg||
pc|s6|pc|s7|pc|sK|pc|s5|pg||
pc|cJ|pc|s9|pc|h2|pc|hQ|pg||
pc|s3|pc|sJ|pc|sA|pc|s8|pg||
pc|sT|pc|sQ|pc|d7|pc|dJ|pg||
pg||
qx|o3|st||md|1SQJ942HJT953D95C5,S653HA2DTCAT76432,SHK87DKQJ87643CQJ,SAKT87HQ64DA2CK98|sv|e|mb|p|mb|2C|an| |mb|5D|mb|6C|mb|6D|mb|d|mb|p|mb|p|mb|p|pg||
pc|sA|pc|s2|pc|s6|pc|d3|pg||
pc|cJ|pc|cK|pc|c5|pc|c7|pg||
pc|dA|pc|d5|pc|dT|pc|dJ|pg||
pc|d2|pc|d9|pc|c2|pc|d4|pg||
pc|hJ|pc|h2|pc|h8|pc|hQ|pg||
pc|c8|pc|h3|pc|cA|pc|cQ|pg||
pc|hA|pc|h7|pc|h4|pc|h5|pg||
mc|8|pg||
qx|c3|st||md|1SQJ942HJT953D95C5,S653HA2DTCAT76432,SHK87DKQJ87643CQJ,SAKT87HQ64DA2CK98|sv|e|mb|p|mb|p|mb|4D|mb|d|mb|p|mb|6C|mb|p|mb|p|mb|p|pg||
pc|dQ|pc|dA|pc|d5|pc|dT|pg||
pc|cK|pc|c5|pc|c3|pc|cJ|pg||
pc|c9|pc|h3|pc|cA|pc|cQ|pg||
pc|s3|pc|d3|pc|sA|pc|s2|pg||
pc|d2|pc|d9|pc|c6|pc|d4|pg||
pc|cT|pc|d6|pc|c8|pc|s4|pg||
pc|c7|pc|d7|pc|s7|pc|h5|pg||
pc|c4|pc|d8|pc|s8|pc|s9|pg||
pc|c2|pc|dJ|pc|h4|pc|hT|pg||
pc|hA|pc|h7|pc|h6|pc|h9|pg||
mc|11|pg||
qx|o4|st||md|2SAJ2HQ62DK4CAK986,SQT64HT3DJ52CQ754,SK853H8DAQ973CJT2,S97HAKJ9754DT86C3|sv|b|mb|p|mb|p|mb|4H|mb|p|mb|p|mb|d|mb|p|mb|5C|mb|p|mb|p|mb|p|pg||
pc|hT|pc|h8|pc|hK|pc|h6|pg||
pc|s7|pc|sA|pc|s4|pc|s3|pg||
pc|h2|pc|h3|pc|c2|pc|h7|pg||
pc|cT|pc|c3|pc|cA|pc|c5|pg||
pc|hQ|pc|d2|pc|cJ|pc|h5|pg||
pc|d3|pc|d8|pc|dK|pc|d5|pg||
pc|cK|pc|c4|pc|s5|pc|h4|pg||
pc|c9|pc|cQ|pc|d7|pc|h9|pg||
pc|dJ|pc|dA|pc|d6|pc|d4|pg||
pc|d9|pc|dT|mc|10|pg||
qx|c4|st||md|2SAJ2HQ62DK4CAK986,SQT64HT3DJ52CQ754,SK853H8DAQ973CJT2,S97HAKJ9754DT86C3|sv|b|mb|p|mb|p|mb|3H|mb|3N|mb|p|mb|p|mb|p|pg||
pc|hT|pc|h8|pc|hJ|pc|hQ|pg||
pc|dK|pc|d2|pc|d3|pc|d8|pg||
pc|d4|pc|d5|pc|dA|pc|d6|pg||
pc|dQ|pc|dT|pc|h2|pc|dJ|pg||
pc|d9|pc|h4|pc|h6|pc|c4|pg||
pc|d7|pc|hA|pc|c6|pc|s4|pg||
pc|cJ|pc|c3|pc|cA|pc|c5|pg||
pc|cK|pc|c7|pc|cT|pc|s7|pg||
pc|sA|pc|s6|pc|s3|pc|s9|pg||
pc|s2|pc|sT|pc|sK|pc|h5|pg||
mc|10|pg||
qx|o5|st||md|3SK54HK93DQ76CQT54,SJT63HA5D952CK876,SA98HQ74DKT3CAJ93,SQ72HJT862DAJ84C2|sv|n|mb|1N|mb|p|mb|3N|mb|p|mb|p|mb|p|pg||
pc|hJ|pc|h3|pc|h5|pc|hQ|pg||
pc|d3|pc|d4|pc|dQ|pc|d5|pg||
pc|cQ|pc|c6|pc|c3|pc|c2|pg||
pc|cT|pc|c7|pc|c9|pc|s2|pg||
pc|c4|pc|c8|pc|cJ|pc|h6|pg||
pc|cA|pc|d8|pc|c5|pc|cK|pg||
pc|h4|pc|h8|pc|h9|pc|hA|pg||
pc|s3|pc|s8|pc|sQ|pc|sK|pg||
pc|d6|pc|d2|pc|dT|pc|dJ|pg||
mc|9|pg||
qx|c5|st||md|3SK54HK93DQ76CQT54,SJT63HA5D952CK876,SA98HQ74DKT3CAJ93,SQ72HJT862DAJ84C2|sv|n|mb|1N|mb|2H!|mb|3N|mb|p|mb|p|mb|p|pg||
pc|s2|pc|sK|pc|s6|pc|s8|pg||
pc|cQ|pc|c8|pc|c3|pc|c2|pg||
pc|cT|pc|cK|pc|cA|pc|h6|pg||
pc|cJ|pc|d4|pc|c5|pc|c6|pg||
pc|c9|pc|h2|pc|c4|pc|c7|pg||
pc|s9|pc|sQ|pc|s4|pc|s3|pg||
pc|s7|pc|s5|pc|sT|pc|sA|pg||
pc|d3|pc|d8|pc|dQ|pc|d2|pg||
pc|d6|pc|d5|pc|dT|pc|dJ|pg||
pc|dA|pc|d7|pc|d9|pc|dK|pg||
pc|hJ|pc|h3|pc|hA|pc|h4|pg||
pc|sJ|pc|h7|pc|h8|pc|h9|pg||
pc|h5|pc|hQ|pc|hT|pc|hK|pg||
pg||
qx|o6|st||md|4S95H873DQJ87CAK87,S842HQ942D963CJT4,SAT73HAKJT6D52C52,SKQJ6H5DAKT4CQ963|sv|e|mb|1D|an| |mb|p|mb|1H|mb|2H|mb|d|an| |mb|4C|mb|p|mb|4H|mb|p|mb|4N|mb|p|mb|5C|mb|p|mb|p|mb|p|pg||
pc|s2|pc|s3|pc|sJ|pc|s5|pg||
pc|dK|pc|d7|pc|d9|pc|d2|pg||
pc|dA|pc|d8|pc|d3|pc|d5|pg||
pc|sQ|pc|s9|pc|s4|pc|sA|pg||
pc|c2|pc|c3|pc|c7|pc|cT|pg||
pc|s8|pc|sT|pc|sK|pc|c8|pg||
pc|cA|pc|c4|pc|c5|pc|c6|pg||
pc|cK|pc|cJ|pc|h6|pc|c9|pg||
mc|8|pg||
qx|c6|st||md|4S95H873DQJ87CAK87,S842HQ942D963CJT4,SAT73HAKJT6D52C52,SKQJ6H5DAKT4CQ963|sv|e|mb|1C|mb|p|mb|p|mb|1H|mb|1S|mb|2C!|mb|p|mb|2D!|mb|p|mb|2H|mb|p|mb|p|mb|p|pg||
pc|sK|pc|s5|pc|s8|pc|s3|pg||
pc|sQ|pc|s9|pc|s2|pc|sA|pg||
pc|sT|pc|s6|pc|d7|pc|s4|pg||
pc|hA|pc|h5|pc|h3|pc|h2|pg||
pc|hK|pc|d4|pc|h7|pc|h4|pg||
pc|s7|pc|sJ|pc|h8|pc|h9|pg||
pc|hQ|pc|h6|pc|c3|pc|c7|pg||
pc|d6|pc|d5|pc|dK|pc|d8|pg||
pc|dA|pc|dJ|pc|d3|pc|d2|pg||
pc|dT|pc|dQ|pc|d9|pc|c2|pg||
pc|cA|pc|c4|pc|c5|pc|c6|pg||
pc|cK|pc|cT|pc|hT|pc|c9|pg||
pc|hJ|pc|cQ|pc|c8|pc|cJ|pg||
pg||
qx|o7|st||md|1S4HJ9532DA4CK9843,SAKQ2H4DKJT3C7652,ST8753HKT7D986CAQ,SJ96HAQ86DQ752CJT|sv|b|mb|p|mb|1D|mb|p|mb|1H|mb|p|mb|1S|mb|p|mb|2D|mb|p|mb|p|mb|p|pg||
pc|d9|pc|d2|pc|dA|pc|d3|pg||
pc|s4|pc|sA|pc|s3|pc|s6|pg||
pc|dJ|pc|d6|pc|d5|pc|d4|pg||
pc|dT|pc|d8|pc|d7|pc|c3|pg||
pc|h4|pc|h7|pc|hQ|mc|10|pg||
qx|c7|st||md|1S4HJ9532DA4CK9843,SAKQ2H4DKJT3C7652,ST8753HKT7D986CAQ,SJ96HAQ86DQ752CJT|sv|b|mb|p|mb|1C|mb|p|mb|1H|mb|p|mb|1S|mb|p|mb|1N|mb|p|mb|p|mb|p|pg||
pc|h3|pc|h4|pc|hK|pc|hA|pg||
pc|d2|pc|d4|pc|dJ|pc|d6|pg||
pc|dK|pc|d8|pc|d5|pc|dA|pg||
pc|c4|pc|c2|pc|cA|pc|cT|pg||
pc|hT|pc|hQ|pc|h2|pc|c5|pg||
pc|dQ|pc|h5|pc|d3|pc|d9|pg||
pc|d7|pc|c3|pc|dT|pc|s5|pg||
pc|s2|pc|s8|pc|sJ|pc|s4|pg||
pc|s9|pc|c8|pc|sQ|pc|s7|pg||
pc|sK|pc|sT|pc|s6|pc|c9|pg||
pc|sA|pc|s3|pc|h6|pc|h9|pg||
pc|c6|pc|cQ|pc|cJ|pc|cK|pg||
pc|hJ|pc|c7|pc|h7|pc|h8|pg||
pg||
qx|o8|st||md|2SAJ5HAQ53DQ64C842,S863HJ7DKJCAQ9765,SK4HK98DAT752CJT3,SQT972HT642D983CK|sv|o|mb|2C|mb|p|mb|p|mb|d|mb|p|mb|3D|mb|p|mb|p|mb|p|pg||
pc|cK|pc|c2|pc|c7|pc|cJ|pg||
pc|sT|pc|s5|pc|s6|pc|sK|pg||
pc|dA|pc|d3|pc|d4|pc|dJ|pg||
pc|d2|pc|d8|pc|d6|pc|dK|pg||
pc|cQ|pc|c3|mc|9|pg||
qx|c8|st||md|2SAJ5HAQ53DQ64C842,S863HJ7DKJCAQ9765,SK4HK98DAT752CJT3,SQT972HT642D983CK|sv|o|mb|p|mb|1D|mb|p|mb|2C!|mb|d|mb|p|mb|p|mb|2D|mb|p|mb|3D|mb|p|mb|p|mb|p|pg||
pc|cK|pc|c2|pc|cA|pc|c3|pg||
pc|cQ|pc|cT|pc|s7|pc|c4|pg||
pc|c7|pc|cJ|pc|d3|pc|c8|pg||
pc|sT|pc|s5|pc|s3|pc|sK|pg||
pc|dA|pc|d8|pc|d4|pc|dJ|pg||
pc|d2|pc|d9|pc|dQ|pc|dK|pg||
mc|9|pg||
qx|o9|st||md|3SKQ73HQ75D98CAQ72,SA92HJ8DK642CJT53,SJTHAT63DT753CK86,S8654HK942DAQJC94|sv|e|mb|p|mb|p|mb|1C|mb|p|mb|1H|mb|p|mb|1S|mb|p|mb|1N|mb|p|mb|p|mb|p|pg||
pc|h2|pc|h5|pc|hJ|pc|hA|pg||
pc|sJ|pc|s6|pc|s3|pc|sA|pg||
pc|h8|pc|h3|pc|h4|pc|hQ|pg||
pc|s7|pc|s9|pc|sT|pc|s5|pg||
pc|c6|pc|c4|pc|cA|pc|c3|pg||
pc|sK|pc|s2|pc|d5|pc|s4|pg||
pc|sQ|pc|d2|pc|dT|pc|s8|pg||
pc|c2|pc|cT|pc|cK|pc|c9|pg||
pc|c8|pc|dJ|pc|cQ|pc|c5|pg||
pc|d8|pc|d4|pc|d3|pc|dA|pg||
pc|dQ|pc|d9|pc|dK|pc|d7|pg||
mc|8|pg||
qx|c9|st||md|3SKQ73HQ75D98CAQ72,SA92HJ8DK642CJT53,SJTHAT63DT753CK86,S8654HK942DAQJC94|sv|e|mb|p|mb|p|mb|1D!|mb|p|mb|1H|mb|p|mb|p|mb|p|pg||
pc|s5|pc|s3|pc|s9|pc|sT|pg||
pc|sJ|pc|s8|pc|s7|pc|sA|pg||
pc|s2|pc|d3|pc|s4|pc|sQ|pg||
pc|d8|pc|d2|pc|d5|pc|dJ|pg||
pc|s6|pc|sK|pc|hJ|pc|hA|pg||
pc|d7|pc|dQ|pc|d9|pc|d4|pg||
pc|c4|pc|c2|pc|cT|pc|cK|pg||
pc|dT|pc|dA|pc|h5|pc|d6|pg||
pc|cA|pc|c3|pc|c6|pc|c9|pg||
pc|cQ|pc|c5|pc|c8|pc|h2|pg||
pc|h4|pc|h7|pc|h8|pc|hT|pg||
pc|h3|pc|hK|pc|hQ|pc|cJ|pg||
pc|h9|pc|c7|pc|dK|pc|h6|pg||
pg||
qx|o10|st||md|4SQJ5HK7DAT6CQ8632,SKT8HJT85DK73CK75,SA9762HQ964D984C9,S43HA32DQJ52CAJT4|sv|b|mb|1N|mb|p|mb|p|mb|p|pg||
pc|c2|pc|c5|pc|c9|pc|cJ|pg||
pc|d2|pc|d6|pc|dK|pc|d4|pg||
pc|d3|pc|d8|pc|dQ|pc|dT|pg||
pc|d5|pc|dA|pc|d7|pc|d9|pg||
pc|sQ|pc|sK|pc|sA|pc|s3|pg||
pc|s7|pc|s4|pc|sJ|pc|s8|pg||
pc|s5|pc|sT|pc|s6|pc|h2|pg||
pc|cK|pc|h4|pc|c4|pc|c3|pg||
pc|c7|pc|h6|mc|9|pg||
qx|c10|st||md|4SQJ5HK7DAT6CQ8632,SKT8HJT85DK73CK75,SA9762HQ964D984C9,S43HA32DQJ52CAJT4|sv|b|mb|1C|mb|p|mb|1H|mb|p|mb|1N|mb|p|mb|p|mb|p|pg||
pc|sQ|pc|sK|pc|s7|pc|s3|pg||
pc|d3|pc|d9|pc|dQ|pc|dA|pg||
pc|sJ|pc|s8|pc|s2|pc|s4|pg||
pc|s5|pc|sT|pc|sA|pc|h2|pg||
pc|s9|pc|c4|pc|c2|pc|h5|pg||
pc|s6|pc|h3|pc|d6|pc|h8|pg||
pc|h4|pc|hA|pc|h7|pc|hT|pg||
pc|d2|pc|dT|pc|dK|pc|d4|pg||
pc|d7|pc|d8|pc|dJ|pc|hK|pg||
pc|d5|pc|c3|pc|hJ|pc|h6|pg||
pc|cT|pc|c6|pc|cK|pc|c9|pg||
pc|c5|pc|h9|pc|cA|pc|c8|pg||
pc|cJ|pc|cQ|pc|c7|pc|hQ|pg||
pg||
qx|o11|st||md|1S653HAQ952D9CK764,SQTH8DJT32CQJT953,SJ2HT64DAK765CA82,SAK9874HKJ73DQ84C|sv|o|mb|p|mb|3C|mb|p|mb|p|mb|3H|mb|p|mb|p|mb|p|pg||
pc|cQ|pc|c2|pc|s7|pc|cK|pg||
pc|s5|pc|sQ|pc|s2|pc|s4|pg||
pc|cJ|pc|c8|pc|s8|pc|c4|pg||
pc|c3|pc|cA|pc|h3|pc|c6|pg||
pc|sA|pc|s3|pc|sT|pc|sJ|pg||
pc|h7|pc|hQ|pc|h8|pc|h4|pg||
pc|hA|pc|c5|pc|h6|pc|hJ|pg||
mc|8|pg||
qx|c11|st||md|1S653HAQ952D9CK764,SQTH8DJT32CQJT953,SJ2HT64DAK765CA82,SAK9874HKJ73DQ84C|sv|o|mb|p|mb|p|mb|1D!|mb|1S|mb|2D!|mb|3C|mb|3H|mb|3S|mb|p|mb|p|mb|p|pg||
pc|d9|pc|d2|pc|dK|pc|d4|pg||
pc|s2|pc|s4|pc|s3|pc|sT|pg||
pc|sQ|pc|sJ|pc|sK|pc|s5|pg||
pc|sA|pc|s6|pc|c5|pc|d5|pg||
pc|dQ|pc|c4|pc|d3|pc|d6|pg||
pc|d8|pc|h5|pc|dT|pc|dA|pg||
pc|h6|pc|hJ|pc|hQ|pc|h8|pg||
pc|c6|pc|c9|pc|cA|pc|s7|pg||
pc|h3|pc|h2|pc|c3|pc|hT|pg||
pc|h4|pc|h7|pc|h9|pc|cT|pg||
pc|hA|pc|dJ|pc|d7|pc|hK|pg||
pc|cK|pc|cJ|pc|c2|pc|s8|pg||
pc|s9|pc|c7|pc|cQ|pc|c8|pg||
pg||
qx|o12|st||md|2SAQ98754H3DQ3C865,STHAQ95DAKJTCKJ74,S32H876D98542CQ93,SKJ6HKJT42D76CAT2|sv|n|mb|1C!|mb|p|mb|1S!|mb|3S|mb|4C!|mb|p|mb|4D!|mb|p|mb|4S!|mb|p|mb|5C!|mb|p|mb|5D!|mb|p|mb|5H|mb|p|mb|p|mb|p|pg||
pc|sA|pc|sT|pc|s2|pc|s6|pg||
pc|s4|pc|hA|pc|s3|pc|sJ|pg||
mc|12|pg||
qx|c12|st||md|2SAQ98754H3DQ3C865,STHAQ95DAKJTCKJ74,S32H876D98542CQ93,SKJ6HKJT42D76CAT2|sv|n|mb|1D|mb|p|mb|1H|mb|3S|mb|d!|mb|p|mb|p|mb|p|pg||
pc|dA|pc|d2|pc|d6|pc|d3|pg||
pc|dK|pc|d4|pc|d7|pc|dQ|pg||
pc|dJ|pc|d5|pc|h2|pc|s4|pg||
pc|sA|pc|sT|pc|s2|pc|s6|pg||
pc|s7|pc|h5|pc|s3|pc|sJ|pg||
pc|sK|pc|s5|pc|c4|pc|h6|pg||
pc|hJ|pc|h3|pc|hQ|pc|h7|pg||
pc|hA|pc|h8|pc|h4|pc|s8|pg||
pc|c5|pc|cK|pc|c3|pc|c2|pg||
pc|h9|pc|d8|pc|hK|pc|s9|pg||
pc|c6|pc|c7|pc|c9|pc|cT|pg||
pc|cA|pc|c8|pc|cJ|pc|cQ|pg||
pc|hT|pc|sQ|pc|dT|pc|d9|pg||
pg||
qx|o13|st||md|3SAJ95H853DAK32CJ5,SQT6HKQJ4D65CA942,SK87HA76DJT4CKQ87,S432HT92DQ987CT63|sv|b|mb|1C|mb|p|mb|1S|mb|p|mb|1N|mb|p|mb|3N|mb|p|mb|p|mb|p|pg||
pc|hT|pc|h3|pc|h4|pc|h7|pg||
pc|h9|pc|h5|pc|hJ|pc|h6|pg||
pc|hQ|pc|hA|pc|h2|pc|h8|pg||
pc|dJ|pc|dQ|pc|dA|pc|d6|pg||
pc|cJ|pc|c2|pc|c8|pc|c6|pg||
pc|c5|pc|c4|pc|cQ|pc|c3|pg||
pc|d4|pc|d7|pc|dK|pc|d5|pg||
pc|d2|pc|s6|pc|dT|pc|d8|pg||
pc|sK|pc|s3|pc|s5|pc|sT|pg||
pc|s8|pc|s2|pc|s9|pc|sQ|pg||
pc|hK|pc|s7|pc|s4|pc|d3|pg||
pc|cA|pc|c7|pc|cT|pc|sJ|pg||
pc|c9|pc|cK|pc|d9|pc|sA|pg||
pg||
qx|c13|st||md|3SAJ95H853DAK32CJ5,SQT6HKQJ4D65CA942,SK87HA76DJT4CKQ87,S432HT92DQ987CT63|sv|b|mb|1D!|mb|p|mb|1S|mb|d|mb|r|mb|p|mb|p|mb|1N|mb|p|mb|p|mb|d|mb|p|mb|p|mb|p|pg||
pc|s7|pc|s2|pc|sA|pc|s6|pg||
pc|s5|pc|sT|pc|sK|pc|s3|pg||
pc|s8|pc|s4|pc|s9|pc|sQ|pg||
pc|h4|pc|h6|pc|hT|pc|h3|pg||
pc|h2|pc|h5|pc|hQ|pc|hA|pg||
pc|c7|pc|c3|pc|cJ|pc|cA|pg||
pc|hK|pc|h7|pc|h9|pc|h8|pg||
pc|hJ|pc|d4|pc|d7|pc|d2|pg||
pc|c2|pc|cQ|pc|c6|pc|c5|pg||
pc|cK|pc|cT|pc|d3|pc|c4|pg||
pc|dT|pc|d8|pc|dK|pc|d5|pg||
pc|dA|pc|d6|pc|dJ|pc|d9|pg||
pc|sJ|pc|c9|pc|c8|pc|dQ|pg||
pg||
qx|o14|st||md|4SAK943H6DAQ984CAT,SQJHAJ985DKT63CKQ,S5HQT73D752C87652,ST8762HK42DJCJ943|sv|o|mb|p|mb|1S|mb|2H|mb|p|mb|3H|mb|d|mb|r|mb|p|mb|p|mb|4D|mb|d|mb|p|mb|p|mb|p|pg||
pc|cK|pc|c2|pc|c3|pc|cA|pg||
pc|h6|pc|h9|pc|h3|pc|hK|pg||
pc|dJ|pc|dA|pc|d3|pc|d2|pg||
pc|sA|pc|sJ|pc|s5|pc|s2|pg||
pc|sK|pc|sQ|pc|c5|pc|s6|pg||
pc|s3|pc|dT|pc|c6|pc|s7|pg||
pc|dK|pc|d5|pc|h4|pc|d8|pg||
pc|d6|pc|d7|pc|c9|pc|d4|pg||
pc|hQ|pc|h2|pc|s4|pc|hA|pg||
pc|cQ|pc|c7|pc|c4|pc|cT|pg||
mc|7|pg||
qx|c14|st||md|4SAK943H6DAQ984CAT,SQJHAJ985DKT63CKQ,S5HQT73D752C87652,ST8762HK42DJCJ943|sv|o|mb|p|mb|1C|mb|1H|mb|p|mb|3H|mb|d|mb|p|mb|4C|mb|p|mb|4D|mb|p|mb|5D|mb|p|mb|p|mb|d|mb|p|mb|p|mb|p|pg||
pc|sJ|pc|s5|pc|s8|pc|sK|pg||
pc|s3|pc|sQ|pc|d2|pc|s7|pg||
pc|c2|pc|c3|pc|cA|pc|cK|pg||
pc|s4|pc|h5|pc|d5|pc|s2|pg||
pc|c5|pc|c4|pc|cT|pc|cQ|pg||
pc|hA|pc|h3|pc|h4|pc|h6|pg||
pc|h9|pc|hT|pc|hK|pc|d4|pg||
pc|s9|pc|dT|pc|c6|pc|s6|pg||
pc|hJ|pc|hQ|pc|h2|pc|sA|pg||
pc|d7|pc|dJ|pc|dQ|pc|dK|pg||
pc|h8|pc|h7|pc|c9|pc|d8|pg||
pc|dA|pc|d3|pc|c7|pc|cJ|pg||
pc|d9|pc|d6|pc|c8|pc|sT|pg||
pg||
qx|o15|st||md|1ST7H864DQ84C97652,SAJ8653HKDJ532CA3,SQ94HQJ92DKT9CKQT,SK2HAT753DA76CJ84|sv|n|mb|p|mb|1S|mb|p|mb|1N|mb|p|mb|2D|mb|p|mb|2H!|mb|p|mb|2N|mb|p|mb|3C!|mb|p|mb|3H|mb|p|mb|4D!|mb|p|mb|4H|mb|p|mb|4S|mb|p|mb|p|mb|p|pg||
pc|cK|pc|c4|pc|c2|pc|cA|pg||
pc|c3|pc|cQ|pc|c8|pc|c5|pg||
pc|h2|pc|h3|pc|h8|pc|hK|pg||
pc|s3|pc|s4|pc|sK|pc|s7|pg||
pc|s2|pc|sT|pc|sJ|pc|sQ|pg||
pc|s9|pc|h5|pc|h4|pc|sA|pg||
mc|10|pg||
qx|c15|st||md|1ST7H864DQ84C97652,SAJ8653HKDJ532CA3,SQ94HQJ92DKT9CKQT,SK2HAT753DA76CJ84|sv|n|mb|p|mb|1S|mb|p|mb|2H|mb|p|mb|2S|mb|p|mb|2N|mb|p|mb|3D|mb|p|mb|3S|mb|p|mb|4S|mb|p|mb|p|mb|p|pg||
pc|cK|pc|c4|pc|c5|pc|cA|pg||
pc|hK|pc|h2|pc|h3|pc|h6|pg||
pc|c3|pc|cQ|pc|c8|pc|c6|pg||
pc|dT|pc|d6|pc|d4|pc|dJ|pg||
pc|s3|pc|s4|pc|sK|pc|s7|pg||
pc|s2|pc|sT|pc|sJ|pc|sQ|pg||
pc|s9|pc|h5|pc|c7|pc|sA|pg||
mc|11|pg||
qx|o16|st||md|2S53HA9832DQCKJ764,S9642HJDAKJ72CQ53,SKJ87HQT65DT863CT,SAQTHK74D954CA982|sv|e|mb|1D!|mb|p|mb|1N!|mb|2D!|mb|d|mb|3D|mb|p|mb|p|mb|d|mb|3H|mb|3N|mb|p|mb|p|mb|p|pg||
pc|h2|pc|hJ|pc|hQ|pc|hK|pg||
pc|d4|pc|dQ|pc|dA|pc|d3|pg||
pc|s2|pc|s8|pc|sA|pc|s3|pg||
pc|d9|pc|c4|pc|d2|pc|dT|pg||
pc|hT|pc|h4|pc|h3|pc|s4|pg||
pc|h6|pc|h7|pc|h8|pc|s6|pg||
pc|hA|pc|c3|pc|h5|pc|c2|pg||
pc|h9|pc|c5|pc|d6|pc|c8|pg||
mc|7|pg||
qx|c16|st||md|2S53HA9832DQCKJ764,S9642HJDAKJ72CQ53,SKJ87HQT65DT863CT,SAQTHK74D954CA982|sv|e|mb|p|mb|p|mb|1C|mb|1H|mb|d|mb|3C!|mb|p|mb|4H|mb|d|mb|p|mb|p|mb|p|pg||
pc|dA|pc|d3|pc|d9|pc|dQ|pg||
pc|dK|pc|d6|pc|d5|pc|h2|pg||
pc|s3|pc|s2|pc|sJ|pc|sQ|pg||
pc|sA|pc|s5|pc|s4|pc|s7|pg||
pc|d4|pc|h3|pc|d2|pc|d8|pg||
pc|c4|pc|cQ|pc|cT|pc|c2|pg||
pc|s6|pc|sK|pc|sT|pc|c6|pg||
pc|s8|pc|c8|pc|h8|pc|s9|pg||
pc|c7|pc|c3|pc|h5|pc|c9|pg||
pc|dT|pc|cA|pc|h9|pc|d7|pg||
pc|hA|pc|hJ|pc|h6|pc|h4|pg||
pc|cJ|pc|c5|pc|hT|pc|hK|pg||
pc|h7|pc|cK|pc|dJ|pc|hQ|pg||
pg||