vg|41st WBTC-BBO7-DOSB,RR19,I,1,16,GERMANY,0,POLAND,0|
rs|1NN+4,2DS+3,6DS-2,3NS+1,5DNx-3,6DNx-4,4SS-2,3NS+1,1NS+1,1NS+1,2HN+1,2DEx-2,3CS-2,3HS-2,3DN+1,3DN=,2HN=,1NN+2,1NE=,1NE=,2SE-1,3CW-3,6HE=,4HE+2,3NN=,3NN=,3HWx-2,4DS-1,4SW=,4SW=,4HS-1,3NE=|
pn|WLADOW,MARKOWICZ,ELINESCU,KLUKOWSKI,ROMANSKI,STRATER,KOWALSKI,KRATZ|pg||
qx|o1|st||md|3S943HQ2DJT73CQ652,SQJ52H8543DK54CK3,ST8HAKTDAQ962CAJ8,SAK76HJ976D8CT974|sv|o|mb|1C|mb|p|mb|1D|mb|p!|mb|1N|mb|p|mb|p|mb|p|pg||
pc|c9|pc|c2|pc|c3|pc|cJ|pg||
pc|hT|pc|hJ|pc|hQ|pc|h3|pg||
pc|dJ|pc|d5|pc|d6|pc|d8|pg||
pc|d3|pc|d4|pc|dQ|pc|h6|pg||
pc|dA|pc|h7|pc|d7|pc|dK|pg||
pc|d9|pc|h9|pc|dT|pc|s2|pg||
pc|h2|pc|h4|pc|hA|pc|s6|pg||
pc|d2|pc|c7|pc|s3|pc|s5|pg||
pc|hK|pc|c4|pc|c5|pc|h5|pg||
pc|cA|pc|cT|pc|c6|pc|cK|pg||
pc|c8|pc|s7|pc|cQ|pc|h8|pg||
pc|s4|pc|sJ|pc|s8|pc|sK|pg||
pc|sA|pc|s9|pc|sQ|pc|sT|pg||
pg||
qx|c1|st||md|3S943HQ2DJT73CQ652,SQJ52H8543DK54CK3,ST8HAKTDAQ962CAJ8,SAK76HJ976D8CT974|sv|o|mb|1C!|mb|p|mb|1D!|mb|p|mb|1H!|mb|p|mb|1N|mb|p|mb|2D|mb|p|mb|p|mb|p|pg||
pc|sQ|pc|s8|pc|s6|pc|s4|pg||
pc|s2|pc|sT|pc|sK|pc|s3|pg||
pc|sA|pc|s9|pc|s5|pc|d2|pg||
pc|hT|pc|h6|pc|hQ|pc|h3|pg||
pc|dJ|pc|dK|pc|dA|pc|d8|pg||
pc|dQ|mc|11|pg||
qx|o2|st||md|4SAT6HK52DAQ8CA965,SQ874HQT973DCT742,SK32H6DK7543CKQJ3,SJ95HAJ84DJT962C8|sv|n|mb|p|mb|1N|mb|p|mb|2C|mb|p|mb|2D|mb|p|mb|3D|mb|p|mb|3N|mb|p|mb|4C|mb|p|mb|4H|mb|p|mb|6C|mb|p|mb|6D|mb|p|mb|p|mb|p|pg||
pc|hT|pc|h6|pc|hA|pc|h2|pg||
pc|s5|pc|sA|pc|s4|pc|s2|pg||
pc|dA|pc|c2|pc|d3|pc|d2|pg||
mc|10|pg||
qx|c2|st||md|4SAT6HK52DAQ8CA965,SQ874HQT973DCT742,SK32H6DK7543CKQJ3,SJ95HAJ84DJT962C8|sv|n|mb|p|mb|1N|mb|p|mb|3H!|mb|p|mb|3N|mb|p|mb|p|mb|p|pg||
pc|hT|pc|h6|pc|hA|pc|h2|pg||
mc|10|pg||
qx|o3|st||md|1SQJ942HJT953D95C5,S653HA2DTCAT76432,SHK87DKQJ87643CQJ,SAKT87HQ64DA2CK98|sv|e|mb|p|mb|p|mb|5D|mb|d|mb|p|mb|p|mb|p|pg||
pc|sA|pc|s2|pc|s5|pc|d3|pg||
pc|cQ|pc|cK|pc|c5|pc|c3|pg||
pc|dA|pc|d5|pc|dT|pc|d4|pg||
pc|d2|pc|d9|pc|c2|pc|d6|pg||
pc|hJ|pc|h2|pc|h8|pc|hQ|pg||
pc|c9|pc|h3|pc|cA|pc|cJ|pg||
pc|hA|pc|h7|pc|h6|pc|h5|pg||
mc|8|pg||
qx|c3|st||md|1SQJ942HJT953D95C5,S653HA2DTCAT76432,SHK87DKQJ87643CQJ,SAKT87HQ64DA2CK98|sv|e|mb|p|mb|p|mb|5D|mb|d|mb|p|mb|6C|mb|p|mb|p|mb|6D|mb|d|mb|p|mb|p|mb|p|pg||
pc|sA|pc|s2|pc|s6|pc|d3|pg||
pc|cJ|pc|cK|pc|c5|pc|c6|pg||
pc|dA|pc|d5|pc|dT|pc|d4|pg||
pc|d2|pc|d9|pc|c2|pc|d7|pg||
pc|hJ|pc|h2|pc|h7|pc|hQ|pg||
pc|c8|pc|s4|pc|cA|pc|cQ|pg||
pc|hA|pc|hK|pc|h4|pc|h3|pg||
pc|cT|mc|8|pg||
qx|o4|st||md|2SAJ2HQ62DK4CAK986,SQT64HT3DJ52CQ754,SK853H8DAQ973CJT2,S97HAKJ9754DT86C3|sv|b|mb|p|mb|p|mb|3H|mb|d|mb|p|mb|4H|mb|p|mb|4S|mb|p|mb|p|mb|p|pg||
pc|hT|pc|h8|pc|hK|pc|h6|pg||
pc|c3|pc|cK|pc|c4|pc|c2|pg||
pc|s2|pc|s4|pc|sK|pc|s7|pg||
pc|s3|pc|s9|pc|sJ|pc|sQ|pg||
pc|s6|pc|s5|pc|h7|pc|sA|pg||
pc|cA|pc|c5|pc|cT|pc|h4|pg||
pc|c6|pc|cQ|pc|cJ|pc|h5|pg||
pc|sT|pc|s8|pc|d6|pc|c8|pg||
pc|h3|pc|d3|pc|hA|pc|h2|pg||
mc|8|pg||
qx|c4|st||md|2SAJ2HQ62DK4CAK986,SQT64HT3DJ52CQ754,SK853H8DAQ973CJT2,S97HAKJ9754DT86C3|sv|b|mb|p|mb|p|mb|3H|mb|3N|mb|p|mb|p|mb|p|pg||
pc|hT|pc|h8|pc|h7|pc|hQ|pg||
pc|cA|pc|c4|pc|cJ|pc|c3|pg||
pc|cK|pc|c5|pc|c2|pc|h4|pg||
pc|dK|pc|d2|pc|d3|pc|d8|pg||
pc|d4|pc|d5|pc|dA|pc|d6|pg||
pc|dQ|pc|dT|pc|h2|pc|dJ|pg||
pc|d9|pc|h5|pc|h6|pc|c7|pg||
pc|d7|pc|s7|pc|c8|pc|s4|pg||
pc|s3|pc|s9|pc|sA|pc|s6|pg||
pc|s2|pc|sT|pc|sK|pc|h9|pg||
mc|10|pg||
qx|o5|st||md|3SK54HK93DQ76CQT54,SJT63HA5D952CK876,SA98HQ74DKT3CAJ93,SQ72HJT862DAJ84C2|sv|n|mb|1C|mb|p|mb|1N|mb|p|mb|p|mb|p|pg||
pc|s3|pc|s8|pc|sQ|pc|s4|pg||
pc|s7|pc|sK|pc|s6|pc|s9|pg||
pc|cT|pc|c6|pc|c3|pc|c2|pg||
pc|c4|pc|c8|pc|cJ|pc|h2|pg||
pc|d3|pc|d4|pc|dQ|pc|d5|pg||
pc|c5|pc|c7|pc|c9|pc|h6|pg||
pc|cA|pc|d8|pc|cQ|pc|cK|pg||
pc|sA|pc|s2|pc|s5|pc|sT|pg||
pc|h4|pc|hT|pc|hK|pc|hA|pg||
pc|sJ|pc|h7|pc|h8|pc|h3|pg||
pc|d2|pc|dT|pc|dJ|pc|d6|pg||
pc|dA|pc|d7|pc|d9|pc|dK|pg||
pc|hJ|pc|h9|pc|h5|pc|hQ|pg||
pg||
qx|c5|st||md|3SK54HK93DQ76CQT54,SJT63HA5D952CK876,SA98HQ74DKT3CAJ93,SQ72HJT862DAJ84C2|sv|n|mb|1C!|mb|p|mb|1N|mb|p|mb|p|mb|p|pg||
pc|s3|pc|s8|pc|sQ|pc|s4|pg||
pc|s7|pc|sK|pc|s6|pc|s9|pg||
pc|cT|pc|cK|pc|cA|pc|c2|pg||
pc|cJ|pc|h6|pc|c4|pc|c6|pg||
pc|c3|pc|h2|pc|cQ|pc|c7|pg||
pc|c5|pc|c8|pc|c9|pc|d4|pg||
pc|dK|pc|dA|pc|d6|pc|d9|pg||
pc|s2|pc|s5|pc|sT|pc|sA|pg||
pc|h4|pc|h8|pc|hK|pc|hA|pg||
pc|sJ|pc|h7|pc|hT|pc|d7|pg||
pc|d5|pc|d3|pc|d8|pc|dQ|pg||
pc|h3|pc|h5|pc|hQ|pc|hJ|pg||
pc|dT|pc|dJ|pc|h9|pc|d2|pg||
pg||
qx|o6|st||md|4S95H873DQJ87CAK87,S842HQ942D963CJT4,SAT73HAKJT6D52C52,SKQJ6H5DAKT4CQ963|sv|e|mb|1D|mb|p|mb|1H|mb|p|mb|1S|mb|p|mb|p|mb|2H|mb|p|mb|p|mb|p|pg||
pc|sK|pc|s5|pc|s4|pc|s3|pg||
pc|sJ|pc|s9|pc|s2|pc|sA|pg||
pc|d2|pc|dK|pc|d7|pc|d6|pg||
pc|s6|pc|h3|pc|s8|pc|s7|pg||
pc|h7|pc|h2|pc|hJ|pc|h5|pg||
pc|c2|pc|c3|pc|cA|pc|c4|pg||
pc|h8|pc|h9|pc|hT|pc|d4|pg||
pc|hA|mc|9|pg||
qx|c6|st||md|4S95H873DQJ87CAK87,S842HQ942D963CJT4,SAT73HAKJT6D52C52,SKQJ6H5DAKT4CQ963|sv|e|mb|1D|mb|p|mb|p|mb|1H|mb|d|mb|r|mb|p|mb|p|mb|1S|mb|p|mb|p|mb|d|mb|p|mb|p|mb|2D|mb|d|mb|p|mb|p|mb|p|pg||
pc|cA|pc|c4|pc|c2|pc|c6|pg||
pc|cK|pc|cT|pc|c5|pc|c3|pg||
pc|c7|pc|cJ|pc|d2|pc|c9|pg||
pc|d5|pc|dA|pc|d7|pc|d3|pg||
pc|sK|pc|s5|pc|s2|pc|sA|pg||
pc|s3|pc|sQ|pc|s9|pc|s4|pg||
pc|cQ|pc|c8|pc|s8|pc|h6|pg||
pc|h5|pc|h7|pc|h9|pc|hT|pg||
pc|sT|pc|sJ|pc|dJ|pc|h2|pg||
mc|6|pg||
qx|o7|st||md|1S4HJ9532DA4CK9843,SAKQ2H4DKJT3C7652,ST8753HKT7D986CAQ,SJ96HAQ86DQ752CJT|sv|b|mb|p|mb|1D|mb|p|mb|1H|mb|2C|mb|p|mb|p|mb|2D|mb|p|mb|p|mb|2S|mb|p|mb|3C|mb|p|mb|p|mb|p|pg||
pc|sA|pc|s3|pc|s6|pc|s4|pg||
pc|s2|pc|s5|pc|sJ|pc|c3|pg||
pc|h3|pc|h4|pc|hT|pc|hQ|pg||
pc|d2|pc|dA|pc|d3|pc|d6|pg||
pc|h2|pc|c2|pc|h7|pc|h6|pg||
pc|c5|pc|cA|pc|cT|pc|c4|pg||
pc|hK|pc|h8|pc|h5|pc|c6|pg||
pc|c7|pc|cQ|pc|cJ|pc|cK|pg||
pc|hJ|pc|dT|pc|s7|pc|hA|pg||
pc|dQ|pc|d4|pc|dK|pc|d8|pg||
pc|dJ|pc|d9|pc|d5|pc|c9|pg||
mc|7|pg||
qx|c7|st||md|1S4HJ9532DA4CK9843,SAKQ2H4DKJT3C7652,ST8753HKT7D986CAQ,SJ96HAQ86DQ752CJT|sv|b|mb|2H!|mb|d|mb|3H|mb|p|mb|p|mb|p|pg||
pc|sA|pc|s3|pc|s9|pc|s4|pg||
pc|s2|pc|s5|pc|sJ|pc|h2|pg||
pc|c4|pc|c2|pc|cQ|pc|cT|pg||
pc|s7|pc|s6|pc|h3|pc|sQ|pg||
pc|c3|pc|c5|pc|cA|pc|cJ|pg||
pc|s8|pc|d2|pc|h5|pc|sK|pg||
pc|cK|pc|c6|pc|d6|pc|h6|pg||
pc|d5|pc|dA|pc|d3|pc|d8|pg||
pc|c8|pc|c7|pc|d9|pc|h8|pg||
pc|dQ|pc|d4|pc|dT|pc|h7|pg||
pc|hK|pc|hA|pc|h9|pc|h4|pg||
pc|hQ|pc|hJ|pc|dJ|pc|hT|pg||
pc|d7|pc|c9|pc|dK|pc|sT|pg||
pg||
qx|o8|st||md|2SAJ5HAQ53DQ64C842,S863HJ7DKJCAQ9765,SK4HK98DAT752CJT3,SQT972HT642D983CK|sv|o|mb|1C|mb|1D|mb|1S|mb|2D|mb|d|mb|p|mb|2S|mb|3D|mb|p|mb|p|mb|p|pg||
pc|cK|pc|c2|pc|c5|pc|cT|pg||
pc|sT|pc|sJ|pc|s6|pc|s4|pg||
pc|s5|pc|s3|pc|sK|pc|s2|pg||
pc|h8|pc|h2|pc|hA|pc|h7|pg||
pc|sA|pc|s8|pc|cJ|pc|s7|pg||
pc|d4|pc|dJ|pc|dA|pc|d3|pg||
pc|d5|pc|d9|pc|d6|pc|dK|pg||
pc|cA|pc|c3|pc|h4|pc|c4|pg||
pc|cQ|pc|dT|pc|h6|pc|c8|pg||
pc|d2|pc|d8|pc|dQ|mc|10|pg||
qx|c8|st||md|2SAJ5HAQ53DQ64C842,S863HJ7DKJCAQ9765,SK4HK98DAT752CJT3,SQT972HT642D983CK|sv|o|mb|1C|mb|1D|mb|p|mb|1H|mb|2C|mb|p|mb|p|mb|d|mb|p|mb|2H|mb|p|mb|3D|mb|p|mb|p|mb|p|pg||
pc|cK|pc|c2|pc|cA|pc|c3|pg||
pc|cQ|pc|cT|pc|s7|pc|c4|pg||
pc|c5|pc|cJ|pc|d9|pc|c8|pg||
pc|h4|pc|h3|pc|hJ|pc|hK|pg||
pc|dA|pc|d3|pc|d4|pc|dJ|pg||
pc|d2|pc|d8|pc|dQ|pc|dK|pg||
mc|9|pg||
qx|o9|st||md|3SKQ73HQ75D98CAQ72,SA92HJ8DK642CJT53,SJTHAT63DT753CK86,S8654HK942DAQJC94|sv|e|mb|p|mb|p|mb|1D|mb|p|mb|1H|mb|p|mb|1S|mb|p|mb|1N|mb|p|mb|2H|mb|p|mb|p|mb|p|pg||
pc|dQ|pc|d8|pc|d2|pc|d3|pg||
pc|h2|pc|h5|pc|hJ|pc|hA|pg||
pc|sJ|pc|s4|pc|s3|pc|s9|pg||
pc|sT|pc|s5|pc|s7|pc|sA|pg||
pc|h8|pc|h3|pc|hK|pc|h7|pg||
pc|dA|pc|d9|pc|d4|pc|d5|pg||
pc|dJ|pc|hQ|pc|d6|pc|d7|pg||
pc|sK|pc|s2|pc|dT|pc|s6|pg||
pc|c2|pc|c3|pc|cK|pc|c4|pg||
pc|hT|pc|h4|pc|c7|pc|c5|pg||
pc|c6|pc|c9|pc|cQ|pc|cT|pg||
pc|cA|pc|cJ|pc|c8|pc|h9|pg||
pc|s8|pc|sQ|pc|dK|pc|h6|pg||
pg||
qx|c9|st||md|3SKQ73HQ75D98CAQ72,SA92HJ8DK642CJT53,SJTHAT63DT753CK86,S8654HK942DAQJC94|sv|e|mb|p|mb|p|mb|1C|mb|p|mb|1H|mb|p|mb|1S|mb|p|mb|1N|mb|p|mb|p|mb|p|pg||
pc|c9|pc|c2|pc|c3|pc|cK|pg||
pc|sJ|pc|s4|pc|s3|pc|s2|pg||
pc|sT|pc|s5|pc|s7|pc|s9|pg||
pc|c8|pc|c4|pc|cQ|pc|c5|pg||
pc|sK|pc|sA|pc|h3|pc|s6|pg||
pc|hJ|pc|h6|pc|h2|pc|hQ|pg||
pc|sQ|pc|d2|pc|c6|pc|s8|pg||
pc|cA|pc|cT|pc|d3|pc|h4|pg||
pc|h5|pc|h8|pc|hA|pc|h9|pg||
mc|9|pg||
qx|o10|st||md|4SQJ5HK7DAT6CQ8632,SKT8HJT85DK73CK75,SA9762HQ964D984C9,S43HA32DQJ52CAJT4|sv|b|mb|1D|mb|p|mb|1H|mb|p|mb|1N|mb|p|mb|p|mb|p|pg||
pc|sQ|pc|s8|pc|s2|pc|s4|pg||
pc|s5|pc|sT|pc|s6|pc|s3|pg||
pc|d3|pc|d8|pc|dQ|pc|d6|pg||
pc|c4|pc|c6|pc|cK|pc|c9|pg||
pc|d7|pc|d4|pc|dJ|pc|dA|pg||
pc|sJ|pc|sK|pc|sA|pc|h3|pg||
pc|s9|pc|h2|pc|c3|pc|h5|pg||
pc|s7|pc|cT|pc|c2|pc|h8|pg||
pc|h4|pc|hA|pc|h7|pc|hT|pg||
pc|d2|pc|dT|pc|dK|pc|d9|pg||
pc|c5|pc|h6|pc|cA|pc|c8|pg||
pc|d5|pc|hK|pc|hJ|pc|h9|pg||
pc|cJ|pc|cQ|pc|c7|pc|hQ|pg||
pg||
qx|c10|st||md|4SQJ5HK7DAT6CQ8632,SKT8HJT85DK73CK75,SA9762HQ964D984C9,S43HA32DQJ52CAJT4|sv|b|mb|1C|mb|p|mb|1H|mb|p|mb|1N|mb|p|mb|p|mb|p|pg||
pc|sQ|pc|s8|pc|s2|pc|s3|pg||
pc|s5|pc|sT|pc|s6|pc|s4|pg||
pc|d3|pc|d8|pc|dQ|pc|dA|pg||
pc|sJ|pc|sK|pc|sA|pc|h2|pg||
pc|s9|pc|c4|pc|c8|pc|h5|pg||
pc|s7|pc|h3|pc|d6|pc|h8|pg||
pc|h4|pc|hA|pc|h7|pc|hT|pg||
pc|d2|pc|dT|pc|dK|pc|d9|pg||
pc|d7|pc|d4|pc|dJ|pc|c2|pg||
pc|d5|pc|hK|pc|hJ|pc|h6|pg||
pc|cT|pc|c3|pc|cK|pc|c9|pg||
mc|7|pg||
qx|o11|st||md|1S653HAQ952D9CK764,SQTH8DJT32CQJT953,SJ2HT64DAK765CA82,SAK9874HKJ73DQ84C|sv|o|mb|p|mb|p|mb|1D|mb|1S|mb|d|mb|p|mb|1N|mb|2S|mb|p|mb|p|mb|p|pg||
pc|d9|pc|d2|pc|dK|pc|dQ|pg||
pc|dA|pc|d4|pc|h5|pc|d3|pg||
pc|d5|pc|d8|pc|s5|pc|dT|pg||
pc|c4|pc|cQ|pc|cA|pc|s4|pg||
pc|sA|pc|s3|pc|sT|pc|s2|pg||
pc|s8|pc|s6|pc|sQ|pc|sJ|pg||
pc|dJ|pc|d6|pc|h3|pc|h2|pg||
pc|h8|pc|h4|pc|hK|pc|hA|pg||
pc|cK|pc|c3|pc|c2|pc|s7|pg||
pc|h7|pc|h9|pc|c5|pc|h6|pg||
pc|hQ|pc|c9|pc|hT|pc|hJ|pg||
mc|7|pg||
qx|c11|st||md|1S653HAQ952D9CK764,SQTH8DJT32CQJT953,SJ2HT64DAK765CA82,SAK9874HKJ73DQ84C|sv|o|mb|p|mb|3C|mb|p|mb|p|mb|p|pg||
pc|dA|pc|d4|pc|d9|pc|d3|pg||
pc|h6|pc|hK|pc|hA|pc|h8|pg||
pc|s5|pc|sQ|pc|s2|pc|s4|pg||
pc|cJ|pc|c2|pc|s7|pc|cK|pg||
pc|s3|pc|sT|pc|sJ|pc|sA|pg||
pc|dQ|pc|h5|pc|d2|pc|dK|pg||
pc|d7|pc|d8|pc|c4|pc|dT|pg||
pc|s6|pc|cQ|pc|cA|pc|s8|pg||
pc|d6|pc|h3|pc|c6|pc|dJ|pg||
pc|c7|mc|6|pg||
qx|o12|st||md|2SAQ98754H3DQ3C865,STHAQ95DAKJTCKJ74,S32H876D98542CQ93,SKJ6HKJT42D76CAT2|sv|n|mb|1C|mb|p|mb|1H|mb|1S|mb|3S|mb|p|mb|4C|mb|p|mb|4D|mb|p|mb|4H|mb|p|mb|4N|mb|p|mb|5H|mb|p|mb|6H|mb|p|mb|p|mb|p|pg||
pc|sA|pc|sT|pc|s2|pc|s6|pg||
pc|d3|pc|dA|pc|d4|pc|d6|pg||
pc|hA|pc|h7|pc|h2|pc|h3|pg||
pc|h5|pc|h8|pc|hT|pc|s5|pg||
pc|hJ|pc|s4|pc|h9|pc|h6|pg||
pc|sK|pc|s7|pc|c4|pc|s3|pg||
pc|sJ|pc|sQ|pc|hQ|pc|d2|pg||
pc|dK|pc|d5|pc|d7|pc|dQ|pg||
mc|12|pg||
qx|c12|st||md|2SAQ98754H3DQ3C865,STHAQ95DAKJTCKJ74,S32H876D98542CQ93,SKJ6HKJT42D76CAT2|sv|n|mb|1D|mb|p|mb|1H|mb|2S|mb|4H|mb|p|mb|p|mb|p|pg||
pc|c6|pc|c4|pc|c9|pc|cT|pg||
pc|hK|pc|h3|pc|h5|pc|h6|pg||
pc|h2|pc|s7|pc|hA|pc|h8|pg||
pc|sT|pc|s2|pc|s6|pc|sQ|pg||
pc|c5|pc|c7|pc|cQ|pc|cA|pg||
pc|sJ|mc|12|pg||
qx|o13|st||md|3SAJ95H853DAK32CJ5,SQT6HKQJ4D65CA942,SK87HA76DJT4CKQ87,S432HT92DQ987CT63|sv|b|mb|1C|mb|p|mb|1S|mb|p|mb|1N|mb|p|mb|3N|mb|p|mb|p|mb|p|pg||
pc|d9|pc|d2|pc|d5|pc|dJ|pg||
pc|c7|pc|c6|pc|cJ|pc|cA|pg||
pc|hK|pc|h6|pc|h9|pc|h5|pg||
pc|h4|pc|h7|pc|hT|pc|h3|pg||
pc|h2|pc|h8|pc|hJ|pc|hA|pg||
pc|dT|pc|dQ|pc|dA|pc|d6|pg||
pc|sJ|pc|sQ|pc|sK|pc|s4|pg||
pc|d4|pc|d7|pc|dK|pc|c2|pg||
pc|c5|pc|c4|pc|cK|pc|c3|pg||
pc|cQ|pc|cT|pc|s5|pc|c9|pg||
pc|c8|pc|s2|pc|d3|pc|hQ|pg||
pc|s7|pc|s3|pc|sA|pc|s6|pg||
pc|s9|pc|sT|pc|s8|pc|d8|pg||
pg||
qx|c13|st||md|3SAJ95H853DAK32CJ5,SQT6HKQJ4D65CA942,SK87HA76DJT4CKQ87,S432HT92DQ987CT63|sv|b|mb|1C|mb|p|mb|1S|mb|p|mb|1N|mb|p|mb|3N|mb|p|mb|p|mb|p|pg||
pc|d7|pc|dA|pc|d6|pc|d4|pg||
pc|cJ|pc|c2|pc|c7|pc|c3|pg||
pc|c5|pc|cA|pc|c8|pc|c6|pg||
pc|hK|pc|h6|pc|h9|pc|h3|pg||
pc|h4|pc|h7|pc|hT|pc|h5|pg||
pc|h2|pc|h8|pc|hJ|pc|hA|pg||
pc|cK|pc|cT|pc|d2|pc|c4|pg||
pc|cQ|pc|d8|pc|s5|pc|c9|pg||
pc|dJ|pc|dQ|pc|dK|pc|d5|pg||
pc|d3|pc|hQ|pc|dT|pc|d9|pg||
pc|sK|pc|s2|pc|s9|pc|s6|pg||
pc|s7|pc|s3|pc|sA|pc|sT|pg||
pc|sJ|pc|sQ|pc|s8|pc|s4|pg||
pg||
qx|o14|st||md|4SAK943H6DAQ984CAT,SQJHAJ985DKT63CKQ,S5HQT73D752C87652,ST8762HK42DJCJ943|sv|o|mb|p|mb|1C|mb|1H|mb|p|mb|2H|mb|2S|mb|3H|mb|d|mb|p|mb|p|mb|p|pg||
pc|s5|pc|s2|pc|sK|pc|sJ|pg||
pc|sA|pc|sQ|pc|d7|pc|s6|pg||
pc|s3|pc|h9|pc|hT|pc|s7|pg||
pc|c5|pc|c3|pc|cA|pc|cK|pg||
pc|s4|pc|hJ|pc|hQ|pc|s8|pg||
pc|d2|pc|dJ|pc|dA|pc|d3|pg||
pc|s9|pc|hA|pc|d5|pc|sT|pg||
pc|cQ|pc|c2|pc|c4|pc|cT|pg||
pc|h8|pc|h3|pc|h2|pc|h6|pg||
pc|h5|pc|h7|pc|hK|pc|d4|pg||
mc|7|pg||
qx|c14|st||md|4SAK943H6DAQ984CAT,SQJHAJ985DKT63CKQ,S5HQT73D752C87652,ST8762HK42DJCJ943|sv|o|mb|p|mb|1S|mb|2H|mb|p|mb|p|mb|d|mb|p|mb|3C|mb|3H|mb|4D|mb|p|mb|p|mb|p|pg||
pc|cK|pc|c2|pc|c3|pc|cA|pg||
pc|sA|pc|sJ|pc|s5|pc|s2|pg||
pc|sK|pc|sQ|pc|h3|pc|s6|pg||
pc|s3|pc|h9|pc|d2|pc|s7|pg||
pc|c5|pc|c4|pc|cT|pc|cQ|pg||
pc|hJ|pc|h7|pc|h4|pc|h6|pg||
pc|h5|pc|hT|pc|hK|pc|d4|pg||
pc|s4|pc|dT|pc|hQ|pc|s8|pg||
pc|d3|pc|d5|pc|dJ|pc|dQ|pg||
pc|s9|pc|h8|pc|d7|pc|sT|pg||
pc|c6|pc|c9|pc|d8|pc|dK|pg||
mc|9|pg||
qx|o15|st||md|1ST7H864DQ84C97652,SAJ8653HKDJ532CA3,SQ94HQJ92DKT9CKQT,SK2HAT753DA76CJ84|sv|n|mb|p|mb|1S|mb|p|mb|2H|mb|p|mb|2S|mb|p|mb|2N|mb|p|mb|3S|mb|p|mb|4S|mb|p|mb|p|mb|p|pg||
pc|cK|pc|c4|pc|c2|pc|cA|pg||
pc|hK|pc|h2|pc|h3|pc|h6|pg||
pc|d2|pc|d9|pc|dA|pc|d4|pg||
pc|hA|pc|h4|pc|c3|pc|h9|pg||
pc|d6|pc|d8|pc|d5|pc|dT|pg||
pc|dK|pc|d7|pc|dQ|pc|d3|pg||
pc|hQ|pc|h5|pc|h8|pc|s3|pg||
pc|s5|pc|s4|pc|sK|pc|s7|pg||
pc|s2|pc|sT|pc|sJ|pc|sQ|pg||
mc|10|pg||
qx|c15|st||md|1ST7H864DQ84C97652,SAJ8653HKDJ532CA3,SQ94HQJ92DKT9CKQT,SK2HAT753DA76CJ84|sv|n|mb|p|mb|1S|mb|p|mb|2H|mb|p|mb|2S|mb|p|mb|2N|mb|p|mb|3S|mb|p|mb|4S|mb|p|mb|p|mb|p|pg||
pc|cK|pc|c4|pc|c2|pc|cA|pg||
pc|hK|pc|h2|pc|h3|pc|h4|pg||
pc|c3|pc|cQ|pc|c8|pc|c5|pg||
pc|cT|pc|cJ|pc|c6|pc|d2|pg||
pc|sK|pc|s7|pc|s3|pc|s4|pg||
pc|s2|pc|sT|pc|sJ|pc|sQ|pg||
pc|s9|pc|h5|pc|h6|pc|sA|pg||
mc|10|pg||
qx|o16|st||md|2S53HA9832DQCKJ764,S9642HJDAKJ72CQ53,SKJ87HQT65DT863CT,SAQTHK74D954CA982|sv|e|mb|p|mb|p|mb|1C|mb|1H|mb|d|mb|3H|mb|p|mb|4H|mb|p|mb|p|mb|p|pg||
pc|dA|pc|d3|pc|d9|pc|dQ|pg||
pc|hJ|pc|hQ|pc|hK|pc|hA|pg||
pc|s3|pc|s2|pc|sJ|pc|sQ|pg||
pc|h7|pc|h3|pc|d2|pc|hT|pg||
pc|cT|pc|c2|pc|cK|pc|c3|pg||
pc|c4|pc|c5|pc|h5|pc|c8|pg||
pc|d6|pc|d5|pc|h2|pc|d7|pg||
pc|c6|pc|cQ|pc|h6|pc|c9|pg||
pc|d8|pc|d4|pc|h8|pc|dJ|pg||
pc|h9|pc|s4|pc|dT|pc|h4|pg||
pc|c7|pc|s6|pc|s7|pc|cA|pg||
pc|sA|pc|s5|pc|s9|pc|s8|pg||
pc|sT|pc|cJ|pc|dK|pc|sK|pg||
pg||
qx|c16|st||md|2S53HA9832DQCKJ764,S9642HJDAKJ72CQ53,SKJ87HQT65DT863CT,SAQTHK74D954CA982|sv|e|mb|1D|mb|p|mb|3N|mb|p|mb|p|mb|p|pg||
pc|c6|pc|c3|pc|cT|pc|cA|pg||
pc|d4|pc|dQ|pc|d2|pc|d8|pg||
pc|c4|pc|cQ|pc|h5|pc|c2|pg||
pc|s2|pc|s7|pc|sT|pc|s3|pg||
pc|d5|pc|h3|pc|dA|pc|d3|pg||
pc|s4|pc|s8|pc|sQ|pc|s5|pg||
pc|sA|pc|h2|pc|s6|pc|sJ|pg||
pc|d9|pc|c7|pc|dK|pc|d6|pg||
mc|9|pg||