vg|41st WBTC-BBO5-VC,RR4,I,17,32,POLAND,0,INDIA,0|
rs|2SN-1,4DW-1,4HE-4,3HE+1,5HS+1,4SEx-1,3DE=,3HN-1,2HW+1,2HE=,2SN-1,3NS-4,2NE-2,2DW-1,4SE+1,4SE+1,1SE+2,1NN-2,4SN=,2SN+3,6HE-4,5SW=,2HN=,2CS=,2DN+2,2DN+2,3NS+1,3NS-1,2NE-1,2CW-1,5HN-1,5HN-1|
pn|ZMUDA,KSHIRSAGAR,KAZMUCHA,BAKUL SHAH,SINGLA,DUFRAT,A Surane,TACZEWSKA|pg||
qx|o17|st||md|3SK54HJT85DT76CQ97,SJ6H76DKQ954CT543,SA98732HQ43DA3CJ6,SQTHAK92DJ82CAK82|sv|o|mb|1S|mb|d|mb|2H|an|.|mb|p|mb|2S|mb|p|mb|p|mb|p|pg||
pc|hA|pc|h5|pc|h7|pc|h3|pg||
pc|hK|pc|h8|pc|h6|pc|h4|pg||
pc|h2|pc|hT|pc|s6|pc|hQ|pg||
pc|c5|pc|c6|pc|cK|pc|c7|pg||
pc|h9|pc|hJ|pc|sJ|pc|sA|pg||
pc|cJ|pc|cA|pc|c9|pc|c3|pg||
mc|7|pg||
qx|c17|st||md|3SK54HJT85DT76CQ97,SJ6H76DKQ954CT543,SA98732HQ43DA3CJ6,SQTHAK92DJ82CAK82|sv|o|mb|1S|mb|d|mb|2S|mb|3D|mb|p|mb|3S|mb|p|mb|4D|mb|p|mb|p|mb|p|pg||
pc|sA|pc|sT|pc|s5|pc|sJ|pg||
pc|s2|pc|sQ|pc|sK|pc|s6|pg||
pc|d6|pc|d5|pc|dA|pc|d2|pg||
pc|d3|pc|d8|pc|d7|pc|d9|pg||
pc|h6|pc|h3|pc|hA|pc|h5|pg||
pc|hK|pc|h8|pc|h7|pc|h4|pg||
pc|h2|pc|hT|pc|dQ|pc|hQ|pg||
pc|c3|pc|c6|pc|cA|pc|c7|pg||
pc|dJ|pc|dT|pc|dK|pc|s3|pg||
pc|c4|pc|cJ|pc|cK|pc|c9|pg||
pc|c2|pc|cQ|pc|c5|pc|s7|pg||
mc|9|pg||
qx|o18|st||md|4S752H963DA4CAKT74,SKT643HKQDKJT2CJ3,SAQJ9HT2DQ8CQ9865,S8HAJ8754D97653C2|sv|n|mb|4H|mb|p|mb|p|mb|p|pg||
pc|cA|pc|c3|pc|c9|pc|c2|pg||
pc|cK|pc|cJ|pc|c8|pc|h4|pg||
pc|h5|pc|h3|pc|hQ|pc|h2|pg||
pc|hK|pc|hT|pc|h7|pc|h6|pg||
pc|s3|pc|s9|pc|s8|pc|s7|pg||
pc|c6|pc|hJ|pc|c7|pc|s4|pg||
pc|hA|pc|h9|pc|s6|pc|sJ|pg||
pc|d3|pc|d4|pc|dT|pc|dQ|pg||
mc|6|pg||
qx|c18|st||md|4S752H963DA4CAKT74,SKT643HKQDKJT2CJ3,SAQJ9HT2DQ8CQ9865,S8HAJ8754D97653C2|sv|n|mb|3H|mb|p|mb|p|mb|p|pg||
pc|cA|pc|c3|pc|c8|pc|c2|pg||
pc|cK|pc|cJ|pc|c9|pc|h4|pg||
pc|d7|pc|dA|pc|d2|pc|d8|pg||
pc|s7|pc|s3|pc|sJ|pc|s8|pg||
pc|h2|pc|h5|pc|h3|pc|hK|pg||
pc|hQ|pc|hT|pc|hA|pc|h6|pg||
pc|hJ|pc|h9|pc|dT|pc|c5|pg||
pc|d3|pc|d4|pc|dK|pc|dQ|pg||
pc|dJ|pc|c6|pc|d5|pc|c4|pg||
mc|10|pg||
qx|o19|st||md|1SHAK642DAJ3CKQ932,SKT976H75DQ874C76,S43HQT83DK2CJT854,SAQJ852HJ9DT965CA|sv|e|mb|1H|mb|p|mb|3H|mb|3S|mb|4C|mb|4S|mb|5C|mb|p|mb|5D|mb|p|mb|5H|mb|p|mb|p|mb|p|pg||
pc|sK|pc|s3|pc|sA|pc|h2|pg||
pc|hA|pc|h5|pc|h3|pc|h9|pg||
pc|hK|pc|h7|pc|h8|pc|hJ|pg||
pc|cK|pc|c6|pc|c4|pc|cA|pg||
mc|12|pg||
qx|c19|st||md|1SHAK642DAJ3CKQ932,SKT976H75DQ874C76,S43HQT83DK2CJT854,SAQJ852HJ9DT965CA|sv|e|mb|1C|mb|p|mb|1D|mb|2S|mb|3H|mb|4S|mb|d|mb|p|mb|p|mb|p|pg||
pc|hA|pc|h5|pc|h8|pc|h9|pg||
pc|cK|pc|c6|pc|c5|pc|cA|pg||
pc|sQ|pc|h2|pc|s6|pc|s3|pg||
pc|s2|pc|c2|pc|sT|pc|s4|pg||
pc|c7|pc|cT|pc|sA|pc|c3|pg||
pc|hJ|pc|hK|pc|h7|pc|h3|pg||
pc|h4|pc|d4|pc|hT|pc|s5|pg||
pc|d9|pc|d3|pc|d7|pc|dK|pg||
pc|d2|pc|d5|pc|dA|pc|d8|pg||
mc|9|pg||
qx|o20|st||md|2SKT42HKJ8DK6CAK82,SQJ9765HQDT5CQT43,SA8HT9754D32CJ976,S3HA632DAQJ9874C5|sv|b|mb|p|mb|p|mb|1D|mb|1N|mb|2S|mb|p|mb|3D|mb|p|mb|p|mb|p|pg||
pc|cA|pc|c3|pc|c9|pc|c5|pg||
pc|dK|pc|d5|pc|d3|pc|dA|pg||
pc|hA|pc|h8|pc|hQ|pc|h5|pg||
pc|h2|pc|hJ|pc|dT|pc|h4|pg||
pc|c4|pc|c6|pc|d4|pc|c8|pg||
mc|9|pg||
qx|c20|st||md|2SKT42HKJ8DK6CAK82,SQJ9765HQDT5CQT43,SA8HT9754D32CJ976,S3HA632DAQJ9874C5|sv|b|mb|2D!|mb|p|mb|p|mb|d|mb|p|mb|2H|mb|3D|mb|3H|mb|p|mb|p|mb|p|pg||
pc|s3|pc|s2|pc|s9|pc|sA|pg||
pc|hT|pc|h2|pc|h8|pc|hQ|pg||
pc|sJ|pc|s8|pc|h3|pc|s4|pg||
pc|c5|pc|cA|pc|c3|pc|c6|pg||
pc|hK|pc|s5|pc|h4|pc|hA|pg||
pc|dA|pc|d6|pc|d5|pc|d2|pg||
pc|d4|pc|dK|pc|dT|pc|d3|pg||
pc|hJ|pc|s6|pc|h5|pc|h6|pg||
pc|sT|pc|sQ|pc|h7|pc|d7|pg||
pc|c7|pc|d8|pc|cK|pc|c4|pg||
pc|sK|pc|s7|pc|c9|pc|d9|pg||
pc|c2|pc|cQ|pc|cJ|mc|8|pg||
qx|o21|st||md|3SKT98H7DKQ985CAJ2,S7HAQJT2DJ763CT64,SA643H983DT2CK987,SQJ52HK654DA4CQ53|sv|n|mb|p|mb|1D|mb|p|mb|1H|mb|p|mb|2H|mb|p|mb|p|mb|p|pg||
pc|h3|pc|h4|pc|h7|pc|hT|pg||
pc|d3|pc|d2|pc|dA|pc|d5|pg||
pc|d4|pc|dQ|pc|d6|pc|dT|pg||
pc|sT|pc|s7|pc|sA|pc|s2|pg||
pc|s3|pc|sQ|pc|sK|pc|hJ|pg||
pc|d7|pc|h9|pc|hK|pc|d8|pg||
pc|h5|pc|d9|pc|hA|pc|h8|pg||
pc|dJ|pc|s4|pc|h6|pc|dK|pg||
pc|sJ|pc|s8|pc|c4|pc|s6|pg||
mc|9|pg||
qx|c21|st||md|3SKT98H7DKQ985CAJ2,S7HAQJT2DJ763CT64,SA643H983DT2CK987,SQJ52HK654DA4CQ53|sv|n|mb|p|mb|1C!|mb|1D|mb|d!|mb|p|mb|2H|mb|p|mb|p|mb|p|pg||
pc|dK|pc|d3|pc|d2|pc|dA|pg||
pc|d4|pc|dQ|pc|d6|pc|dT|pg||
pc|d9|pc|d7|pc|s6|pc|h4|pg||
pc|h5|pc|h7|pc|hT|pc|h3|pg||
pc|hQ|pc|h8|pc|h6|pc|s8|pg||
pc|s7|pc|s3|pc|sQ|pc|sK|pg||
pc|d5|pc|dJ|pc|h9|pc|hK|pg||
pc|s2|pc|s9|pc|h2|pc|s4|pg||
pc|cT|pc|c7|pc|c3|pc|cJ|pg||
pc|sT|pc|c4|pc|sA|pc|s5|pg||
pc|c8|pc|c5|pc|c2|pc|c6|pg||
pc|cK|pc|cQ|pc|cA|pc|hJ|pg||
pc|hA|pc|c9|pc|sJ|pc|d8|pg||
pg||
qx|o22|st||md|4S7HKJ973DQ984C863,SJ543HAQ5DA2CJ754,SAK9862H6DKJ3CKT2,SQTHT842DT765CAQ9|sv|e|mb|p|mb|p|mb|1D|mb|1S|mb|1N|mb|p|mb|p|mb|2S|mb|p|mb|p|mb|p|pg||
pc|h2|pc|hJ|pc|hQ|pc|h6|pg||
pc|c7|pc|c2|pc|c9|pc|c3|pg||
pc|h4|pc|h9|pc|hA|pc|s2|pg||
pc|sA|pc|sT|pc|s7|pc|s3|pg||
pc|sK|pc|sQ|pc|h3|pc|s4|pg||
pc|s9|pc|d5|pc|d4|pc|sJ|pg||
pc|c4|pc|cK|pc|cA|pc|c6|pg||
pc|cQ|pc|c8|pc|c5|pc|cT|pg||
pc|d6|pc|d8|pc|dA|pc|d3|pg||
pc|cJ|pc|s6|pc|h8|pc|h7|pg||
mc|7|pg||
qx|c22|st||md|4S7HKJ973DQ984C863,SJ543HAQ5DA2CJ754,SAK9862H6DKJ3CKT2,SQTHT842DT765CAQ9|sv|e|mb|p|mb|p|mb|1C!|mb|d|mb|1D!|mb|p|mb|1H!|mb|2S|mb|p|mb|2N|mb|p|mb|3N|mb|p|mb|p|mb|p|pg||
pc|c4|pc|c2|pc|c9|pc|c3|pg||
pc|h8|pc|hK|pc|hA|pc|h6|pg||
pc|c5|pc|cK|pc|cA|pc|c6|pg||
pc|cQ|pc|c8|pc|c7|pc|cT|pg||
pc|sQ|pc|s7|pc|s3|pc|sA|pg||
pc|dK|pc|d5|pc|d4|pc|dA|pg||
pc|cJ|pc|s2|pc|h2|pc|h3|pg||
pc|d2|pc|d3|pc|d6|pc|d8|pg||
pc|d9|pc|s4|pc|dJ|pc|d7|pg||
pc|sK|pc|sT|pc|h7|pc|s5|pg||
pc|s6|pc|dT|pc|dQ|pc|sJ|pg||
pc|hQ|pc|s8|pc|h4|pc|h9|pg||
pc|h5|pc|s9|pc|hT|pc|hJ|pg||
pg||
qx|o23|st||md|1SQ65H84D986CQT876,SJ84HKJ976DAQ72C9,SAT9HAQ53DJ53CK53,SK732HT2DKT4CAJ42|sv|b|mb|p|mb|1H|mb|p|mb|1S|mb|p|mb|2D|mb|p|mb|2N|mb|p|mb|p|mb|p|pg||
pc|c7|pc|c9|pc|cK|pc|cA|pg||
pc|hT|pc|h4|pc|h6|pc|hQ|pg||
pc|c5|pc|c2|pc|c6|pc|s4|pg||
pc|d8|pc|d2|pc|dJ|pc|dK|pg||
pc|h2|pc|h8|pc|hK|pc|hA|pg||
pc|c3|pc|c4|pc|c8|pc|s8|pg||
pc|cQ|pc|sJ|pc|h5|pc|cJ|pg||
pc|cT|pc|h7|pc|d3|pc|s2|pg||
pc|s5|pc|h9|pc|sA|pc|s3|pg||
mc|6|pg||
qx|c23|st||md|1SQ65H84D986CQT876,SJ84HKJ976DAQ72C9,SAT9HAQ53DJ53CK53,SK732HT2DKT4CAJ42|sv|b|mb|p|mb|1H|mb|1N|mb|d|mb|2C|mb|2D|mb|p|mb|p|mb|p|pg||
pc|c3|pc|cA|pc|c7|pc|c9|pg||
pc|hT|pc|h4|pc|h6|pc|hQ|pg||
pc|cK|pc|c2|pc|c6|pc|d2|pg||
pc|hJ|pc|hA|pc|h2|pc|h8|pg||
pc|h3|pc|s2|pc|d6|pc|h7|pg||
pc|s5|pc|s8|pc|sA|pc|s3|pg||
pc|h5|pc|s7|pc|d8|pc|h9|pg||
pc|s6|pc|s4|pc|s9|pc|sK|pg||
pc|dK|pc|d9|pc|d7|pc|d3|pg||
pc|d4|pc|c8|pc|dQ|pc|d5|pg||
pc|dA|pc|dJ|pc|dT|pc|cT|pg||
pc|hK|pc|sT|pc|c4|pc|cQ|pg||
pc|sJ|pc|c5|pc|cJ|pc|sQ|pg||
pg||
qx|o24|st||md|2S54HKQ64DAT3CKJ43,SAT6HAJT97DKJ875C,S83H852D62CAQT875,SKQJ972H3DQ94C962|sv|o|mb|1H|mb|3C|mb|3S|mb|p|mb|4C|mb|p|mb|4S|mb|p|mb|p|mb|p|pg||
pc|s4|pc|s6|pc|s3|pc|s7|pg||
pc|c2|pc|c3|pc|sT|pc|c5|pg||
pc|d5|pc|d2|pc|dQ|pc|dT|pg||
pc|c6|pc|c4|pc|sA|pc|c7|pg||
pc|hA|pc|h5|pc|h3|pc|h4|pg||
pc|h7|pc|h2|pc|s2|pc|h6|pg||
pc|sQ|pc|s5|pc|h9|pc|s8|pg||
mc|11|pg||
qx|c24|st||md|2S54HKQ64DAT3CKJ43,SAT6HAJT97DKJ875C,S83H852D62CAQT875,SKQJ972H3DQ94C962|sv|o|mb|1H|mb|p|mb|1S|mb|p|mb|2D|mb|p|mb|2S|mb|p|mb|4S|mb|p|mb|p|mb|p|pg||
pc|s5|pc|s6|pc|s8|pc|sQ|pg||
pc|d9|pc|d3|pc|dK|pc|d2|pg||
pc|d5|pc|d6|pc|dQ|pc|dA|pg||
pc|dT|pc|dJ|pc|s3|pc|d4|pg||
pc|cA|pc|c2|pc|c4|pc|sA|pg||
pc|sT|pc|c5|pc|sK|pc|s4|pg||
mc|11|pg||
qx|o25|st||md|3SQ5HQJ32DK85C8754,SJ84HK975DA964CT6,SAK63HT64DT3CKJ92,ST972HA8DQJ72CAQ3|sv|e|mb|p|mb|1D|mb|p|mb|1H|mb|d|mb|1S|mb|p|mb|p|mb|p|pg||
pc|c7|pc|cT|pc|cJ|pc|cQ|pg||
pc|cA|pc|c4|pc|c6|pc|c2|pg||
pc|c3|pc|c5|pc|s4|pc|c9|pg||
pc|h5|pc|h4|pc|hA|pc|h2|pg||
pc|dQ|pc|dK|pc|dA|pc|d3|pg||
pc|d4|pc|dT|pc|dJ|pc|d5|pg||
pc|d2|pc|d8|pc|d9|pc|s3|pg||
pc|s6|pc|s2|pc|sQ|pc|s8|pg||
pc|s5|pc|sJ|pc|sK|pc|s7|pg||
pc|sA|pc|s9|pc|h3|pc|h7|pg||
mc|9|pg||
qx|c25|st||md|3SQ5HQJ32DK85C8754,SJ84HK975DA964CT6,SAK63HT64DT3CKJ92,ST972HA8DQJ72CAQ3|sv|e|mb|1D|mb|p|mb|1H|mb|p|mb|1N|mb|p|mb|p|mb|p|pg||
pc|s9|pc|s5|pc|sJ|pc|sA|pg||
pc|h4|pc|hA|pc|h2|pc|h5|pg||
pc|s2|pc|sQ|pc|s4|pc|s3|pg||
pc|c4|pc|c6|pc|cJ|pc|cQ|pg||
pc|h8|pc|h3|pc|h7|pc|hT|pg||
pc|h6|pc|d2|pc|hQ|pc|hK|pg||
pc|s8|pc|sK|pc|s7|pc|c5|pg||
pc|d3|pc|d7|pc|dK|pc|dA|pg||
pc|cT|pc|cK|pc|cA|pc|c7|pg||
pc|dQ|pc|d5|pc|d4|pc|dT|pg||
pc|dJ|pc|d8|pc|d6|mc|5|pg||
qx|o26|st||md|4SJ5HQDT9874CT9432,S974HA965D532CQ86,SAKQT86HK3DQCAKJ5,S32HJT8742DAKJ6C7|sv|b|mb|2D|mb|p|mb|2H|mb|d|mb|p|mb|2N|mb|p|mb|4S|mb|p|mb|p|mb|p|pg||
pc|dK|pc|d4|pc|d2|pc|dQ|pg||
pc|s2|pc|sJ|pc|s4|pc|s6|pg||
pc|s5|pc|s7|pc|sA|pc|s3|pg||
pc|sK|pc|h4|pc|d7|pc|s9|pg||
pc|sQ|pc|h2|pc|d8|pc|h6|pg||
pc|h3|pc|hJ|pc|hQ|pc|hA|pg||
pc|d3|pc|s8|pc|d6|pc|d9|pg||
pc|cA|pc|c7|pc|c2|pc|c6|pg||
pc|cK|pc|h7|pc|c3|pc|c8|pg||
mc|10|pg||
qx|c26|st||md|4SJ5HQDT9874CT9432,S974HA965D532CQ86,SAKQT86HK3DQCAKJ5,S32HJT8742DAKJ6C7|sv|b|mb|p|mb|p|mb|p|mb|1C!|mb|d!|mb|p|mb|1D!|mb|2S|mb|p|mb|p|mb|p|pg||
pc|dA|pc|d4|pc|d5|pc|dQ|pg||
pc|s2|pc|s5|pc|s9|pc|sK|pg||
pc|s6|pc|s3|pc|sJ|pc|s4|pg||
pc|cT|pc|c8|pc|c5|pc|c7|pg||
pc|c9|pc|c6|pc|cJ|pc|h8|pg||
pc|sA|pc|h2|pc|d7|pc|s7|pg||
pc|sQ|pc|d6|pc|d8|pc|d2|pg||
pc|cA|pc|dJ|pc|c2|pc|cQ|pg||
pc|cK|pc|h7|pc|c3|pc|h6|pg||
pc|h3|pc|hT|pc|hQ|pc|hA|pg||
pc|d3|pc|s8|pc|dK|pc|d9|pg||
pc|sT|pc|h4|pc|c4|pc|h5|pg||
pc|hK|pc|hJ|pc|dT|pc|h9|pg||
pg||
qx|o27|st||md|1STHAT962DT63CKJ73,SQJ76432H3D84CQT9,S9HJ854DKJ752C652,SAK85HKQ7DAQ9CA84|sv|o|mb|p|mb|2D|mb|p|mb|2N|mb|p|mb|3C|mb|p|mb|4N|mb|p|mb|5C|mb|p|mb|6H|mb|p|mb|p|mb|p|pg||
pc|d6|pc|d4|pc|dJ|pc|dQ|pg||
pc|dA|pc|d3|pc|d8|pc|d2|pg||
pc|d9|pc|dT|pc|h3|pc|d5|pg||
pc|s2|pc|s9|pc|sA|pc|sT|pg||
pc|hK|pc|h2|pc|s3|pc|h4|pg||
pc|hQ|pc|hA|pc|s4|pc|h5|pg||
pc|c3|pc|c9|pc|c6|pc|c4|pg||
pc|s6|pc|h8|pc|s5|pc|c7|pg||
pc|dK|pc|h7|pc|h9|pc|s7|pg||
pc|cJ|pc|cQ|pc|c2|pc|c8|pg||
pc|cT|pc|c5|pc|cA|pc|cK|pg||
pc|sK|pc|h6|pc|sJ|pc|d7|pg||
pc|hT|pc|sQ|pc|hJ|pc|s8|pg||
pg||
qx|c27|st||md|1STHAT962DT63CKJ73,SQJ76432H3D84CQT9,S9HJ854DKJ752C652,SAK85HKQ7DAQ9CA84|sv|o|mb|p|mb|3S|mb|p|mb|4C!|mb|p|mb|4S|mb|p|mb|4N|mb|p|mb|5C!|mb|p|mb|5H!|mb|p|mb|5S|mb|p|mb|p|mb|p|pg||
pc|h4|pc|hK|pc|hA|pc|h3|pg||
pc|hT|pc|d8|pc|h5|pc|hQ|pg||
pc|sA|pc|sT|pc|s2|pc|s9|pg||
pc|h7|pc|h2|pc|s6|pc|h8|pg||
pc|d4|pc|d2|pc|dA|pc|d6|pg||
pc|d9|pc|d3|pc|s3|pc|d5|pg||
pc|s7|pc|c2|pc|s8|pc|h6|pg||
pc|dQ|pc|dT|pc|sJ|pc|d7|pg||
pc|cQ|pc|c5|pc|c4|pc|cK|pg||
mc|11|pg||
qx|o28|st||md|2SAK85HADT42CKT965,SQ97H97654DKQJCJ3,SJT6HKJT32D965CA7,S432HQ8DA873CQ842|sv|n|mb|p|mb|p|mb|p|mb|1C|mb|p|mb|1H|mb|p|mb|1S|mb|p|mb|2H|mb|p|mb|p|mb|p|pg||
pc|c2|pc|c9|pc|cJ|pc|cA|pg||
pc|h2|pc|h8|pc|hA|pc|h4|pg||
pc|cK|pc|c3|pc|c7|pc|c4|pg||
pc|c5|pc|s7|pc|h3|pc|c8|pg||
pc|s6|pc|s2|pc|sA|pc|s9|pg||
pc|sK|pc|sQ|pc|sT|pc|s3|pg||
pc|c6|pc|dJ|pc|hT|pc|cQ|pg||
pc|d5|pc|d3|pc|d4|pc|dQ|pg||
pc|h5|pc|hJ|pc|hQ|pc|s5|pg||
mc|8|pg||
qx|c28|st||md|2SAK85HADT42CKT965,SQ97H97654DKQJCJ3,SJT6HKJT32D965CA7,S432HQ8DA873CQ842|sv|n|mb|p|mb|p|mb|p|mb|2C|mb|p|mb|p|mb|p|pg||
pc|dK|pc|d5|pc|d3|pc|d2|pg||
pc|dQ|pc|d6|pc|d7|pc|d4|pg||
pc|dJ|pc|d9|pc|d8|pc|dT|pg||
pc|h7|pc|hJ|pc|hQ|pc|hA|pg||
pc|c5|pc|c3|pc|cA|pc|c2|pg||
pc|hK|pc|h8|pc|s5|pc|h4|pg||
pc|hT|pc|c4|pc|c6|pc|h5|pg||
pc|cK|pc|cJ|pc|c7|pc|c8|pg||
pc|sA|pc|s7|pc|s6|pc|s2|pg||
pc|c9|pc|h6|pc|h2|pc|cQ|pg||
pc|dA|pc|cT|pc|h9|pc|h3|pg||
pc|sK|pc|s9|pc|sT|pc|s3|pg||
pc|s8|pc|sQ|pc|sJ|pc|s4|pg||
pg||
qx|o29|st||md|3SAT742HQ3D865C962,SJ95H82DQJCAQT875,SK6HAKT75DKT972C4,SQ83HJ964DA43CKJ3|sv|b|mb|1H|mb|p|mb|1S|mb|p|mb|2D|mb|p|mb|p|mb|p|pg||
pc|s3|pc|sA|pc|s5|pc|s6|pg||
pc|d5|pc|dJ|pc|dK|pc|dA|pg||
pc|sQ|pc|s2|pc|s9|pc|sK|pg||
pc|d2|pc|d3|pc|d8|pc|dQ|pg||
pc|cA|pc|c4|pc|c3|pc|c2|pg||
pc|c8|pc|d7|pc|cJ|pc|c6|pg||
pc|h5|pc|h4|pc|hQ|pc|h2|pg||
pc|h3|pc|h8|pc|hA|pc|h6|pg||
pc|h7|pc|h9|pc|d6|pc|c5|pg||
pc|c9|pc|cT|pc|d9|pc|cK|pg||
mc|10|pg||
qx|c29|st||md|3SAT742HQ3D865C962,SJ95H82DQJCAQT875,SK6HAKT75DKT972C4,SQ83HJ964DA43CKJ3|sv|b|mb|1H|mb|p|mb|1S|mb|p|mb|2D|mb|p|mb|p|mb|p|pg||
pc|d3|pc|d5|pc|dQ|pc|dK|pg||
pc|d2|pc|d4|pc|d6|pc|dJ|pg||
pc|cA|pc|c4|pc|c3|pc|c2|pg||
pc|c8|pc|d7|pc|cK|pc|c6|pg||
pc|h7|pc|h4|pc|hQ|pc|h2|pg||
pc|h3|pc|h8|pc|hK|pc|h6|pg||
pc|hA|pc|h9|pc|c9|pc|c5|pg||
pc|h5|pc|hJ|pc|s2|pc|c7|pg||
mc|10|pg||
qx|o30|st||md|4SQ53HA7DK876CAJ87,SKT76HKT5DQJ2C643,SAJHJ8432D94CKQ95,S9842HQ96DAT53CT2|sv|o|mb|p|mb|1C|mb|p|mb|1H|mb|p|mb|1N|mb|p|mb|2C|mb|p|mb|2D|mb|p|mb|2H|mb|p|mb|3N|mb|p|mb|p|mb|p|pg||
pc|s6|pc|sJ|pc|s8|pc|s3|pg||
pc|h2|pc|h6|pc|hA|pc|h5|pg||
pc|h7|pc|hT|pc|hJ|pc|hQ|pg||
pc|s2|pc|s5|pc|s7|pc|sA|pg||
pc|h3|pc|h9|pc|d6|pc|hK|pg||
pc|sK|pc|d4|pc|s4|pc|sQ|pg||
pc|sT|pc|c5|pc|s9|mc|10|pg||
qx|c30|st||md|4SQ53HA7DK876CAJ87,SKT76HKT5DQJ2C643,SAJHJ8432D94CKQ95,S9842HQ96DAT53CT2|sv|o|mb|p|mb|1D|mb|p|mb|1H|mb|p|mb|1N|mb|p|mb|3N|mb|p|mb|p|mb|p|pg||
pc|s6|pc|sJ|pc|s2|pc|s3|pg||
pc|h2|pc|h6|pc|hA|pc|h5|pg||
pc|h7|pc|hT|pc|h3|pc|hQ|pg||
pc|s9|pc|s5|pc|s7|pc|sA|pg||
pc|h4|pc|h9|pc|c7|pc|hK|pg||
pc|sK|pc|d4|pc|s8|pc|sQ|pg||
pc|sT|pc|d9|pc|s4|pc|d6|pg||
pc|dQ|pc|h8|pc|dA|pc|d7|pg||
mc|8|pg||
qx|o31|st||md|1SAQ74HQJ972D74CQJ,SJ82H854DJT9CAT62,SK65H3D86532CK974,ST93HAKT6DAKQC853|sv|n|mb|1H|mb|p|mb|p|mb|d|mb|p|mb|2C|mb|p|mb|2N|mb|p|mb|p|mb|p|pg||
pc|hQ|pc|h4|pc|h3|pc|hA|pg||
pc|c3|pc|cJ|pc|c2|pc|c7|pg||
pc|cQ|pc|c6|pc|c4|pc|c5|pg||
pc|d4|pc|d9|pc|d2|pc|dQ|pg||
pc|s3|pc|sQ|pc|s2|pc|s6|pg||
pc|d7|pc|dT|pc|d3|pc|dK|pg||
pc|s9|pc|s4|pc|s8|pc|sK|pg||
pc|d5|pc|dA|pc|h2|pc|dJ|pg||
pc|sT|pc|sA|pc|sJ|pc|s5|pg||
pc|s7|pc|h5|pc|d6|pc|h6|pg||
pc|h7|pc|h8|pc|d8|pc|hT|pg||
mc|7|pg||
qx|c31|st||md|1SAQ74HQJ972D74CQJ,SJ82H854DJT9CAT62,SK65H3D86532CK974,ST93HAKT6DAKQC853|sv|n|mb|1H|mb|p|mb|p|mb|d|mb|p|mb|2C|mb|p|mb|p|mb|p|pg||
pc|h3|pc|hA|pc|h7|pc|h5|pg||
pc|c3|pc|cQ|pc|cA|pc|c4|pg||
pc|c2|pc|c9|pc|c5|pc|cJ|pg||
pc|sA|pc|s2|pc|s5|pc|s3|pg||
pc|s4|pc|s8|pc|sK|pc|s9|pg||
pc|d2|pc|dQ|pc|d4|pc|d9|pg||
pc|c8|pc|d7|pc|c6|pc|cK|pg||
pc|d3|pc|dK|pc|h2|pc|dT|pg||
pc|dA|pc|h9|pc|dJ|pc|d5|pg||
pc|sT|pc|sQ|pc|sJ|pc|s6|pg||
pc|hQ|pc|h4|pc|c7|pc|h6|pg||
mc|7|pg||
qx|o32|st||md|2S4H864DAT32CQJT98,SK9653H9DKQ985C75,SAQ8HAKQ752DJ76C2,SJT72HJT3D4CAK643|sv|e|mb|2S|mb|3H|mb|4S|mb|5H|mb|p|mb|p|mb|p|pg||
pc|cK|pc|c8|pc|c7|pc|c2|pg||
pc|d4|pc|d2|pc|dQ|pc|d7|pg||
pc|d9|pc|dJ|pc|hT|pc|d3|pg||
pc|s2|pc|s4|pc|sK|pc|sA|pg||
pc|s8|pc|sT|pc|h6|pc|s3|pg||
pc|h4|pc|h9|pc|hA|mc|10|pg||
qx|c32|st||md|2S4H864DAT32CQJT98,SK9653H9DKQ985C75,SAQ8HAKQ752DJ76C2,SJT72HJT3D4CAK643|sv|e|mb|2S!|mb|d|mb|4S|mb|5C|mb|p|mb|5H|mb|p|mb|p|mb|p|pg||
pc|d4|pc|d2|pc|dQ|pc|d7|pg||
pc|c5|pc|c2|pc|cK|pc|c8|pg||
pc|h3|pc|h4|pc|h9|pc|hQ|pg||
pc|sA|pc|s2|pc|s4|pc|s3|pg||
pc|s8|pc|sJ|pc|h6|pc|s5|pg||
pc|cQ|pc|c7|pc|h2|pc|c3|pg||
pc|sQ|pc|s7|pc|h8|pc|s6|pg||
pc|cJ|pc|d5|pc|h5|pc|c4|pg||
pc|hA|pc|hT|pc|d3|pc|d8|pg||
pc|hK|pc|hJ|pc|c9|pc|s9|pg||
pc|h7|pc|sT|pc|cT|pc|sK|pg||
pc|dJ|pc|c6|pc|dA|pc|d9|pg||
pc|dT|pc|dK|pc|d6|pc|cA|pg||
pg||