vg|41st WBTC-BBO6-VC,RR6,I,17,32,CANADA,0,USA2,0|
rs|4HN-1,4HS-1,4SN-1,2SN=,3DE+3,3NE-2,4SWx-3,3NS+3,3DW+2,2HS-1,5DE=,3NW+1,3SE-1,1NN-1,,5HS-2,,2SS+1,,1SE+2,,2HS-1,,3CS-2,,,,,,,,|
pn|SUMMERS-CA,MEYERS,CIMON,ZUR-CAMPAN,SEAMON-MOL,THORPE,EYTHORSDOT,DEMME|pg||
qx|o17|st||md|3SKT7HKJ64DKJ2CAQ3,SAQJ96H9D874CKJT8,S5HQT875DA65C9642,S8432HA32DQT93C75|sv|o|mb|p|mb|p|mb|1N|mb|2S|mb|2N!|mb|3S|mb|4C|mb|p|mb|4H|mb|p|mb|p|mb|p|pg||
pc|s3|pc|s7|pc|s9|pc|s5|pg||
pc|h9|pc|hT|pc|h3|pc|h4|pg||
pc|c4|pc|c5|pc|cQ|pc|cK|pg||
pc|cJ|pc|c2|pc|c7|pc|cA|pg||
pc|hJ|pc|s6|pc|h5|pc|hA|pg||
pc|s2|pc|sT|pc|sJ|pc|h7|pg||
pc|h8|pc|h2|pc|hK|pc|sQ|pg||
pc|c3|pc|cT|pc|c6|pc|s4|pg||
mc|9|pg||
qx|c17|st||md|3SKT7HKJ64DKJ2CAQ3,SAQJ96H9D874CKJT8,S5HQT875DA65C9642,S8432HA32DQT93C75|sv|o|mb|p|mb|p|mb|1N|mb|p|mb|2D!|mb|p|mb|3H|mb|p|mb|4H|mb|p|mb|p|mb|p|pg||
pc|d4|pc|d5|pc|dQ|pc|dK|pg||
pc|h6|pc|h9|pc|hT|pc|hA|pg||
pc|dT|pc|dJ|pc|d7|pc|d6|pg||
pc|hK|pc|s6|pc|h5|pc|h3|pg||
pc|h4|pc|d8|pc|h7|pc|h2|pg||
pc|dA|pc|d3|pc|d2|pc|c8|pg||
pc|s5|pc|s2|pc|sT|pc|sJ|pg||
pc|sA|pc|h8|pc|s3|pc|s7|pg||
pc|c6|pc|c7|pc|c3|pc|cT|pg||
pc|s9|pc|c2|pc|s4|pc|sK|pg||
pc|hJ|pc|sQ|pc|hQ|pc|s8|pg||
pc|c4|pc|c5|pc|cQ|pc|cK|pg||
pc|cJ|pc|c9|pc|d9|pc|cA|pg||
pg||
qx|o18|st||md|4SK43HQ2DAJ75CAQ96,S9652H84D42CK8432,SQJT8H653DKQ93CJT,SA7HAKJT97DT86C75|sv|n|mb|1H|mb|d|mb|p|mb|2S|mb|p|mb|3H!|mb|p|mb|3S|mb|p|mb|4S|mb|p|mb|p|mb|p|pg||
pc|hA|pc|h2|pc|h4|pc|h3|pg||
pc|hK|pc|hQ|pc|h8|pc|h5|pg||
pc|hJ|pc|sK|pc|c3|pc|h6|pg||
pc|s3|pc|s2|pc|sQ|pc|sA|pg||
pc|c7|pc|c6|pc|cK|pc|cT|pg||
pc|c4|pc|cJ|pc|c5|pc|c9|pg||
pc|sJ|pc|s7|pc|s4|pc|s5|pg||
pc|d3|pc|d6|pc|dJ|pc|d2|pg||
pc|cA|pc|c2|pc|d9|pc|d8|pg||
pc|cQ|pc|c8|pc|dQ|pc|h7|pg||
pc|dA|pc|d4|pc|dK|pc|dT|pg||
mc|9|pg||
qx|c18|st||md|4SK43HQ2DAJ75CAQ96,S9652H84D42CK8432,SQJT8H653DKQ93CJT,SA7HAKJT97DT86C75|sv|n|mb|1H|mb|d|mb|p|mb|1S|mb|2H|mb|p|mb|p|mb|2S|mb|p|mb|p|mb|p|pg||
pc|hK|pc|h2|pc|h4|pc|h5|pg||
pc|hA|pc|hQ|pc|h8|pc|h6|pg||
pc|hJ|pc|sK|pc|d4|pc|h3|pg||
pc|s3|pc|s2|pc|sJ|pc|sA|pg||
pc|d6|pc|d5|pc|d2|pc|d9|pg||
pc|sQ|pc|s7|pc|s4|pc|s5|pg||
pc|sT|pc|h7|pc|c6|pc|s6|pg||
pc|cJ|pc|c5|pc|c9|pc|cK|pg||
mc|8|pg||
qx|o19|st||md|1ST93H9754DACAQJ98,SKJ874HA32DQJTCT3,SA652HJT86D765C76,SQHKQDK98432CK542|sv|e|mb|1C!|mb|1S|mb|d|mb|2D|mb|2H|mb|3D|mb|p|mb|p|mb|p|pg||
pc|h9|pc|h2|pc|h6|pc|hK|pg||
pc|sQ|pc|s3|pc|s4|pc|s2|pg||
pc|hQ|pc|h4|pc|h3|pc|h8|pg||
pc|d2|pc|dA|pc|dT|pc|d5|pg||
pc|sT|pc|sJ|pc|sA|pc|d3|pg||
pc|d4|pc|c8|pc|dJ|pc|d6|pg||
pc|sK|pc|s5|pc|c2|pc|s9|pg||
pc|dQ|pc|d7|pc|d8|pc|h5|pg||
pc|hA|pc|hT|pc|c4|pc|h7|pg||
mc|12|pg||
qx|c19|st||md|1ST93H9754DACAQJ98,SKJ874HA32DQJTCT3,SA652HJT86D765C76,SQHKQDK98432CK542|sv|e|mb|1C|mb|1S|mb|p|mb|2D|mb|p|mb|3D|mb|p|mb|3N|mb|p|mb|p|mb|p|pg||
pc|cA|pc|c3|pc|c7|pc|c2|pg||
pc|cJ|pc|cT|pc|c6|pc|c4|pg||
pc|c8|pc|s4|pc|s2|pc|cK|pg||
pc|hK|pc|h4|pc|h2|pc|h6|pg||
pc|d3|pc|dA|pc|dT|pc|d5|pg||
pc|cQ|pc|s7|pc|d6|pc|c5|pg||
pc|c9|pc|s8|pc|d7|pc|sQ|pg||
pc|s3|pc|sJ|pc|sA|pc|d2|pg||
mc|7|pg||
qx|o20|st||md|2SAKHKJ9DK7CQJ8765,SQJ98743H43DA8C32,S62HAQ652DJT5CKT9,ST5HT87DQ96432CA4|sv|b|mb|3S|mb|p|mb|4S|mb|d|mb|p|mb|p|mb|p|pg||
pc|s2|pc|s5|pc|sK|pc|s4|pg||
pc|sA|pc|s3|pc|s6|pc|sT|pg||
pc|cQ|pc|c2|pc|c9|pc|cA|pg||
pc|c4|pc|c5|pc|c3|pc|cT|pg||
pc|hA|pc|h7|pc|h9|pc|h3|pg||
pc|h5|pc|h8|pc|hK|pc|h4|pg||
pc|hJ|pc|s7|pc|h2|pc|hT|pg||
pc|sQ|pc|h6|pc|d2|pc|c6|pg||
pc|sJ|pc|hQ|pc|d3|pc|c7|pg||
pc|s9|pc|d5|pc|d4|pc|c8|pg||
pc|s8|pc|cK|pc|d6|pc|cJ|pg||
pc|dA|pc|dT|pc|d9|pc|d7|pg||
pc|d8|pc|dJ|pc|dQ|pc|dK|pg||
pg||
qx|c20|st||md|2SAKHKJ9DK7CQJ8765,SQJ98743H43DA8C32,S62HAQ652DJT5CKT9,ST5HT87DQ96432CA4|sv|b|mb|3S|mb|p|mb|p|mb|3N|mb|p|mb|p|mb|p|pg||
pc|sQ|pc|s2|pc|s5|pc|sK|pg||
pc|c5|pc|c2|pc|cK|pc|cA|pg||
pc|sT|pc|sA|pc|s3|pc|s6|pg||
pc|hK|pc|h4|pc|h2|pc|h7|pg||
mc|12|pg||
qx|o21|st||md|3SKQ5H953DA7CK9852,SAJ42HA4DK843CAJ4,ST9763HKQ72DJCT73,S8HJT86DQT9652CQ6|sv|n|mb|p|mb|p|mb|1C|mb|1N|mb|2D!|mb|3C!|mb|p|mb|3D|mb|p|mb|p|mb|p|pg||
pc|hK|pc|h6|pc|h3|pc|hA|pg||
pc|d3|pc|dJ|pc|dQ|pc|dA|pg||
pc|sK|pc|sA|pc|s7|pc|s8|pg||
pc|dK|pc|s3|pc|d2|pc|d7|pg||
pc|h4|pc|hQ|pc|h8|pc|h5|pg||
mc|11|pg||
qx|c21|st||md|3SKQ5H953DA7CK9852,SAJ42HA4DK843CAJ4,ST9763HKQ72DJCT73,S8HJT86DQT9652CQ6|sv|n|mb|p|mb|p|mb|1C|mb|1N|mb|2D!|mb|p|mb|2H|mb|p|mb|p|mb|p|pg||
pc|hA|pc|h2|pc|h6|pc|h5|pg||
pc|h4|pc|hK|pc|h8|pc|h3|pg||
pc|s3|pc|s8|pc|sK|pc|sA|pg||
pc|s2|pc|s6|pc|hT|pc|s5|pg||
pc|c6|pc|c2|pc|cJ|pc|c3|pg||
pc|s4|pc|s7|pc|hJ|pc|sQ|pg||
pc|cQ|pc|cK|pc|cA|pc|c7|pg||
mc|7|pg||
qx|o22|st||md|4SJ743HQ85DJ3CJ854,S82HAJ943D986CK92,SQTHKT72DQ5CAQT73,SAK965H6DAKT742C6|sv|e|mb|1D|mb|p|mb|1H|mb|2C|mb|2S!|mb|4C|mb|p|mb|p|mb|4S|mb|p|mb|5D|mb|p|mb|p|mb|p|pg||
pc|c5|pc|c2|pc|cQ|pc|c6|pg||
pc|d5|pc|dA|pc|d3|pc|d6|pg||
pc|sK|pc|s3|pc|s2|pc|sT|pg||
pc|sA|pc|s4|pc|s8|pc|sQ|pg||
pc|s5|pc|s7|pc|d8|pc|dQ|pg||
pc|h2|pc|h6|pc|hQ|pc|hA|pg||
pc|c9|pc|c3|pc|d2|pc|c4|pg||
pc|s6|pc|sJ|pc|d9|pc|h7|pg||
pc|cK|pc|cA|pc|d4|pc|c8|pg||
pc|dK|pc|dJ|pc|h3|pc|c7|pg||
mc|11|pg||
qx|c22|st||md|4SJ743HQ85DJ3CJ854,S82HAJ943D986CK92,SQTHKT72DQ5CAQT73,SAK965H6DAKT742C6|sv|e|mb|1D|mb|p|mb|1H|mb|2C|mb|2D|mb|p|mb|3D|mb|p|mb|3S|mb|p|mb|3N|mb|p|mb|p|mb|p|pg||
pc|cQ|pc|c6|pc|c4|pc|cK|pg||
pc|d8|pc|d5|pc|dA|pc|dJ|pg||
pc|dK|pc|d3|pc|d6|pc|dQ|pg||
pc|dT|pc|c5|pc|d9|pc|sQ|pg||
pc|d7|pc|s3|pc|h3|pc|c3|pg||
pc|d4|pc|h5|pc|c2|pc|h2|pg||
pc|d2|pc|h8|pc|h4|mc|10|pg||
qx|o23|st||md|1SQTHAT763DK97CJ84,S9852HKJ42DT8CAQ9,SK6HQ9DAQ32CK7632,SAJ743H85DJ654CT5|sv|b|mb|p|mb|p|mb|1D|mb|1S|mb|2H|mb|3D!|mb|p|mb|3S|mb|p|mb|p|mb|p|pg||
pc|d7|pc|d8|pc|dA|pc|d5|pg||
pc|d2|pc|d4|pc|dK|pc|dT|pg||
pc|h7|pc|hK|pc|h9|pc|h5|pg||
pc|h2|pc|hQ|pc|h8|pc|h6|pg||
pc|s6|pc|sJ|pc|sQ|pc|s2|pg||
pc|h3|pc|h4|pc|sK|pc|c5|pg||
mc|8|pg||
qx|c23|st||md|1SQTHAT763DK97CJ84,S9852HKJ42DT8CAQ9,SK6HQ9DAQ32CK7632,SAJ743H85DJ654CT5|sv|b|mb|p|mb|p|mb|1C|mb|p|mb|1H|mb|p|mb|1N|mb|p|mb|p|mb|p|pg||
pc|s4|pc|sQ|pc|s2|pc|s6|pg||
pc|h3|pc|h2|pc|h9|pc|h5|pg||
pc|d2|pc|d4|pc|dK|pc|d8|pg||
pc|d7|pc|dT|pc|dA|pc|d5|pg||
pc|dQ|pc|d6|pc|d9|pc|s5|pg||
pc|d3|pc|dJ|pc|h6|pc|c9|pg||
pc|h8|pc|hA|pc|h4|pc|hQ|pg||
pc|sT|pc|s9|pc|sK|pc|sA|pg||
pc|sJ|pc|c4|pc|s8|pc|c2|pg||
pc|s7|pc|c8|pc|cQ|pc|c3|pg||
pc|s3|pc|cJ|pc|hJ|pc|c6|pg||
pc|c5|pc|h7|pc|cA|pc|c7|pg||
pc|hK|pc|cK|pc|cT|pc|hT|pg||
pg||
qx|c24|st||md|2SHDC,SHDC,SHDC,SHDC|sv|o|mb|p|mb|p|mb|1S|mb|2H|mb|4S|mb|5C|mb|p|mb|5H|mb|p|mb|p|mb|p|pg||
pc|sK|pc|s6|pc|s3|pc|s7|pg||
pc|d5|pc|d7|pc|dJ|pc|dA|pg||
pc|dK|pc|d9|pc|d8|pc|h4|pg||
pc|hA|pc|h7|pc|h2|pc|h3|pg||
pc|h5|pc|hK|pc|d3|pc|h8|pg||
pc|hQ|pc|d2|pc|c3|pc|h9|pg||
pc|h6|pc|s2|pc|sT|pc|hJ|pg||
mc|9|pg||
qx|c25|st||md|3SHDC,SHDC,SHDC,SHDC|sv|e|mb|p|mb|1C|mb|1S|mb|d|mb|2S|mb|p|mb|p|mb|p|pg||
pc|cA|pc|c4|pc|c5|pc|c2|pg||
pc|cQ|pc|c7|pc|cK|pc|c3|pg||
pc|cJ|pc|c6|pc|d6|pc|cT|pg||
pc|dA|pc|d7|pc|d5|pc|d3|pg||
pc|c9|pc|c8|pc|s9|pc|sJ|pg||
mc|9|pg||
qx|c26|st||md|4SHDC,SHDC,SHDC,SHDC|sv|b|mb|1S|mb|p|mb|p|mb|p|pg||
pc|h7|pc|h2|pc|hT|pc|hA|pg||
pc|cK|pc|cA|pc|c2|pc|c8|pg||
pc|c3|pc|c4|pc|cJ|pc|cQ|pg||
pc|sA|pc|s4|pc|s2|pc|s6|pg||
pc|sK|pc|s5|pc|sT|pc|s7|pg||
pc|sQ|pc|d3|pc|d2|pc|s9|pg||
pc|hQ|pc|h5|pc|h9|pc|h3|pg||
pc|d4|pc|d5|pc|d9|pc|dJ|pg||
pc|sJ|pc|s3|pc|h8|pc|d6|pg||
pc|dK|pc|dT|pc|dA|pc|d7|pg||
pc|c6|pc|c5|pc|h4|pc|c7|pg||
pc|cT|pc|c9|pc|d8|pc|h6|pg||
pc|s8|pc|hJ|pc|hK|pc|dQ|pg||
pg||
qx|c27|st||md|1SHDC,SHDC,SHDC,SHDC|sv|o|mb|2H|mb|p|mb|p|mb|p|pg||
pc|cJ|pc|cA|pc|c2|pc|c6|pg||
pc|h8|pc|h5|pc|h2|pc|hQ|pg||
pc|d4|pc|d7|pc|dK|pc|d2|pg||
pc|dA|pc|d8|pc|d5|pc|dQ|pg||
pc|d3|pc|dJ|pc|d6|pc|s4|pg||
pc|hA|pc|h4|pc|c5|pc|h7|pg||
pc|h6|pc|c4|pc|s5|pc|hJ|pg||
mc|7|pg||
qx|c28|st||md|2SHDC,SHDC,SHDC,SHDC|sv|n|mb|p|mb|1N|mb|p|mb|2S!|mb|p|mb|2N|mb|p|mb|3C|mb|p|mb|p|mb|p|pg||
pc|h7|pc|h4|pc|hQ|pc|h3|pg||
pc|s3|pc|s9|pc|sT|pc|sA|pg||
pc|dK|pc|dA|pc|d9|pc|d7|pg||
pc|s5|pc|s2|pc|sK|pc|s7|pg||
pc|hJ|pc|hA|pc|h2|pc|h8|pg||
pc|dQ|pc|d4|pc|hT|pc|d6|pg||
pc|h5|pc|hK|pc|c2|pc|h9|pg||
pc|c3|pc|c8|pc|cT|pc|cA|pg||
pc|sQ|pc|sJ|pc|s4|pc|s8|pg||
pc|dT|pc|c4|pc|d3|pc|d2|pg||
pc|c5|pc|cK|pc|c7|pc|c9|pg||
pc|d5|pc|d8|pc|s6|pc|c6|pg||
pc|cJ|pc|dJ|pc|cQ|pc|h6|pg||
pg||