vg|41st WBTC-BBO2-BB,RR17,I,1,16,ARGENTINA,0,CANADA,0|
rs|4HN+1,4HN+1,2NW+1,2SE+1,2NS-1,1NS+2,4HN=,2HN+2,4SE+2,6SE-1,6DW=,6DW=,1NW=,1NW=,3HE-1,4HE-2,2NE+2,1NE+1,4SW-1,4SW-1,2SW-3,2NE-3,4SE=,4SE+1,3NN+1,2DN-1,4SW=,4HN=,3SE=,4SE=,3NW=,3NW+1|
pn|CAMBEROS,KORBEL,PELLEGRINI,D WOLPERT,THURSTON,ALUJAS,SMITH,RAVENNA|pg||
qx|o1|st||md|3SK42H9743DQT85CA8,SJTHT65D942CJ9764,SA97HAKJ2DAJ3CT32,SQ8653HQ8DK76CKQ5|sv|o|mb|1N|mb|p|mb|2C|mb|p|mb|2H|mb|p|mb|4H|mb|p|mb|p|mb|p|pg||
pc|cQ|pc|cA|pc|c4|pc|c2|pg||
pc|dT|pc|d4|pc|d3|pc|dK|pg||
pc|d7|pc|d5|pc|d2|pc|dA|pg||
pc|hA|pc|h8|pc|h3|pc|h5|pg||
pc|hK|pc|hQ|pc|h4|pc|h6|pg||
pc|hJ|pc|s5|pc|h7|pc|hT|pg||
pc|dJ|pc|d6|pc|dQ|pc|d9|pg||
pc|d8|pc|c6|pc|s7|pc|s3|pg||
mc|11|pg||
qx|c1|st||md|3SK42H9743DQT85CA8,SJTHT65D942CJ9764,SA97HAKJ2DAJ3CT32,SQ8653HQ8DK76CKQ5|sv|o|mb|1C|mb|1S|mb|d|mb|p|mb|4H|mb|p|mb|p|mb|p|pg||
pc|s3|pc|s2|pc|sT|pc|sA|pg||
pc|hA|pc|h8|pc|h3|pc|h5|pg||
pc|hK|pc|hQ|pc|h4|pc|h6|pg||
pc|hJ|pc|s5|pc|h7|pc|hT|pg||
pc|dA|pc|d6|pc|d5|pc|d2|pg||
pc|dJ|pc|dK|pc|d8|pc|d4|pg||
pc|s6|pc|sK|pc|sJ|pc|s7|pg||
pc|dQ|pc|d9|pc|d3|pc|d7|pg||
pc|dT|pc|c4|pc|s9|pc|s8|pg||
mc|11|pg||
qx|o2|st||md|4SK87HJT3DQJ876CT3,SJHK95DAT9CK98642,ST62HAQ762DK32CQJ,SAQ9543H84D54CA75|sv|n|mb|1S|mb|p|mb|1N|mb|p|mb|2S|mb|p|mb|2N|mb|p|mb|p|mb|p|pg||
pc|h2|pc|h4|pc|hT|pc|hK|pg||
pc|c2|pc|cQ|pc|cA|pc|c3|pg||
pc|c5|pc|cT|pc|cK|pc|cJ|pg||
pc|sJ|pc|s6|pc|sA|pc|s7|pg||
pc|c7|pc|d6|pc|c9|mc|9|pg||
qx|c2|st||md|4SK87HJT3DQJ876CT3,SJHK95DAT9CK98642,ST62HAQ762DK32CQJ,SAQ9543H84D54CA75|sv|n|mb|2S|mb|p|mb|p|mb|p|pg||
pc|dJ|pc|d9|pc|d3|pc|d5|pg||
pc|d7|pc|dA|pc|dK|pc|d4|pg||
pc|sJ|pc|s6|pc|s4|pc|sK|pg||
pc|hJ|pc|hK|pc|hA|pc|h4|pg||
pc|hQ|pc|h8|pc|h3|pc|h5|pg||
pc|h6|pc|s5|pc|hT|pc|h9|pg||
pc|sA|pc|s7|pc|c2|pc|s2|pg||
pc|sQ|pc|s8|pc|c4|pc|sT|pg||
pc|cA|pc|c3|pc|c6|pc|cJ|pg||
pc|c5|pc|cT|pc|cK|pc|cQ|pg||
mc|9|pg||
qx|o3|st||md|1SQJ4HA4D764CAJ752,SK65HQ86DJ852CK96,SA832HJT5DAQT3CT3,ST97HK9732DK9CQ84|sv|e|mb|1C|mb|p|mb|1S|mb|p|mb|1N|mb|p|mb|2C|mb|p|mb|2D|mb|p|mb|2N|mb|p|mb|p|mb|p|pg||
pc|d2|pc|dT|pc|dK|pc|d7|pg||
pc|h3|pc|h4|pc|hQ|pc|h5|pg||
pc|h8|pc|hT|pc|h7|pc|hA|pg||
pc|sJ|pc|s5|pc|s2|pc|s9|pg||
pc|c5|pc|c6|pc|cT|pc|cQ|pg||
pc|hK|pc|d4|pc|h6|pc|hJ|pg||
pc|h9|pc|c2|pc|s6|pc|s3|pg||
pc|h2|pc|c7|pc|c9|pc|s8|pg||
pc|c8|pc|cA|pc|cK|pc|c3|pg||
pc|cJ|pc|d5|pc|d3|pc|c4|pg||
pc|d6|pc|d8|pc|dQ|pc|d9|pg||
pc|dA|pc|s7|pc|s4|pc|dJ|pg||
pc|sA|pc|sT|pc|sQ|pc|sK|pg||
pg||
qx|c3|st||md|1SQJ4HA4D764CAJ752,SK65HQ86DJ852CK96,SA832HJT5DAQT3CT3,ST97HK9732DK9CQ84|sv|e|mb|1C|mb|p|mb|1S|mb|p|mb|1N|mb|p|mb|p|mb|p|pg||
pc|d2|pc|dT|pc|dK|pc|d4|pg||
pc|d9|pc|d7|pc|d5|pc|dQ|pg||
pc|s2|pc|s7|pc|sQ|pc|sK|pg||
pc|dJ|pc|dA|pc|h2|pc|d6|pg||
pc|s3|pc|sT|pc|sJ|pc|s5|pg||
pc|s4|pc|s6|pc|sA|pc|s9|pg||
pc|s8|pc|c4|pc|c2|pc|c6|pg||
pc|c3|pc|c8|pc|cA|pc|c9|pg||
pc|c5|pc|cK|pc|cT|pc|cQ|pg||
pc|d8|pc|d3|pc|h3|pc|h4|pg||
mc|9|pg||
qx|o4|st||md|2ST62HKT643D84CK97,SK84HJ5D965CAT543,SAQJ9HA982DKQTCJ8,S753HQ7DAJ732CQ62|sv|b|mb|p|mb|1N|mb|p|mb|2D|mb|p|mb|3H|mb|p|mb|4H|mb|p|mb|p|mb|p|pg||
pc|s3|pc|s2|pc|sK|pc|sA|pg||
pc|h2|pc|h7|pc|hK|pc|h5|pg||
pc|h3|pc|hJ|pc|hA|pc|hQ|pg||
pc|s9|pc|s5|pc|sT|pc|s4|pg||
pc|d4|pc|d6|pc|dK|pc|dA|pg||
pc|s7|pc|s6|pc|s8|pc|sQ|pg||
pc|sJ|pc|d2|pc|c7|pc|c3|pg||
pc|dQ|pc|d3|pc|d8|pc|d5|pg||
pc|c8|pc|c2|pc|cK|pc|cA|pg||
pc|c4|pc|cJ|pc|cQ|pc|c9|pg||
pc|dJ|pc|h4|pc|d9|pc|dT|pg||
pc|hT|pc|c5|pc|h8|pc|c6|pg||
pc|h6|pc|cT|pc|h9|pc|d7|pg||
pg||
qx|c4|st||md|2ST62HKT643D84CK97,SK84HJ5D965CAT543,SAQJ9HA982DKQTCJ8,S753HQ7DAJ732CQ62|sv|b|mb|p|mb|1C|mb|p|mb|1D|mb|p|mb|1N|mb|p|mb|2D|mb|p|mb|2H|mb|p|mb|p|mb|p|pg||
pc|s3|pc|sT|pc|sK|pc|sA|pg||
pc|hA|pc|h7|pc|h3|pc|h5|pg||
pc|h2|pc|hQ|pc|hK|pc|hJ|pg||
pc|d4|pc|d5|pc|dK|pc|dA|pg||
pc|s5|pc|s2|pc|s8|pc|sQ|pg||
pc|sJ|pc|s7|pc|s6|pc|s4|pg||
pc|s9|pc|d2|pc|c7|pc|c3|pg||
pc|dQ|pc|d3|pc|d8|pc|d6|pg||
pc|c8|pc|c2|pc|cK|pc|cA|pg||
pc|c4|pc|cJ|pc|cQ|pc|c9|pg||
mc|10|pg||
qx|o5|st||md|3SJTHKJT943D953C87,SA64HQ62DAQ762C94,S872H85DJT84CAQJ6,SKQ953HA7DKCKT532|sv|n|mb|p|mb|1S|mb|p|mb|2D|mb|p|mb|3C|mb|p|mb|3S|mb|p|mb|4D|mb|p|mb|4S|mb|p|mb|p|mb|p|pg||
pc|hJ|pc|hQ|pc|h5|pc|h7|pg||
pc|c4|pc|c6|pc|cK|pc|c7|pg||
pc|c5|pc|c8|pc|c9|pc|cA|pg||
pc|h8|pc|hA|pc|h9|pc|h2|pg||
pc|c3|pc|sJ|pc|sA|pc|cJ|pg||
pc|s4|pc|s2|pc|sK|pc|sT|pg||
pc|dK|pc|d3|pc|dA|pc|d4|pg||
pc|dQ|pc|d8|pc|c2|pc|d5|pg||
pc|h6|pc|dJ|pc|s3|pc|h3|pg||
pc|cT|pc|h4|pc|s6|pc|cQ|pg||
pc|d2|pc|dT|pc|s5|pc|d9|pg||
pc|sQ|pc|hT|pc|d6|pc|s7|pg||
pc|s9|pc|hK|pc|d7|pc|s8|pg||
pg||
qx|c5|st||md|3SJTHKJT943D953C87,SA64HQ62DAQ762C94,S872H85DJT84CAQJ6,SKQ953HA7DKCKT532|sv|n|mb|p|mb|1S|mb|p|mb|2D|mb|p|mb|3C|mb|p|mb|3S|mb|p|mb|3N|mb|p|mb|4S|mb|p|mb|4N|mb|p|mb|5H|mb|p|mb|6S|mb|p|mb|p|mb|p|pg||
pc|sT|pc|sA|pc|s2|pc|s3|pg||
pc|c4|pc|cA|pc|c3|pc|c7|pg||
pc|s8|pc|sK|pc|sJ|pc|s4|pg||
pc|cK|pc|c8|pc|c9|pc|c6|pg||
pc|c2|pc|h3|pc|s6|pc|cJ|pg||
pc|dA|pc|d4|pc|dK|pc|d3|pg||
pc|dQ|pc|d8|pc|h7|pc|d5|pg||
mc|11|pg||
qx|o6|st||md|4S643HJT5D754CAJ96,S2HAKQ762DAQJT6CT,SKJT875H843D8CQ52,SAQ9H9DK932CK8743|sv|e|mb|1C|mb|p|mb|1H|mb|2S|mb|p|mb|3S|mb|6D|mb|p|mb|p|mb|p|pg||
pc|sJ|pc|sA|pc|s4|pc|s2|pg||
pc|d2|pc|d4|pc|dQ|pc|d8|pg||
pc|dJ|pc|s5|pc|d3|pc|d5|pg||
pc|hA|pc|h4|pc|h9|pc|h5|pg||
pc|h2|pc|h3|pc|d9|pc|hT|pg||
pc|dK|pc|d7|mc|12|pg||
qx|c6|st||md|4S643HJT5D754CAJ96,S2HAKQ762DAQJT6CT,SKJT875H843D8CQ52,SAQ9H9DK932CK8743|sv|e|mb|1C|mb|p|mb|1D|mb|2S|mb|p|mb|p|mb|d|mb|p|mb|2N|mb|p|mb|3D|mb|p|mb|3N|mb|p|mb|4D|mb|p|mb|4S|mb|p|mb|4N|mb|p|mb|5H|mb|p|mb|6D|mb|p|mb|p|mb|p|pg||
pc|c2|pc|cK|pc|cA|pc|cT|pg||
pc|c6|pc|dT|pc|c5|pc|c3|pg||
pc|dA|pc|d8|pc|d2|pc|d4|pg||
pc|hA|pc|h3|pc|h9|pc|h5|pg||
pc|h2|pc|h4|pc|d9|pc|hT|pg||
mc|12|pg||
qx|o7|st||md|1SAT4HK8432DQT64C9,SQ75HQ9DKJ87CAKQ5,SKJ93HA65D932C432,S862HJT7DA5CJT876|sv|b|mb|p|mb|1N|mb|p|mb|p|mb|p|pg||
pc|s3|pc|s2|pc|sA|pc|s5|pg||
pc|sT|pc|sQ|pc|sK|pc|s6|pg||
pc|sJ|pc|s8|pc|s4|pc|s7|pg||
pc|s9|pc|d5|pc|d6|pc|d8|pg||
pc|hA|pc|h7|pc|h2|pc|h9|pg||
pc|h6|pc|hT|pc|hK|pc|hQ|pg||
pc|d4|mc|7|pg||
qx|c7|st||md|1SAT4HK8432DQT64C9,SQ75HQ9DKJ87CAKQ5,SKJ93HA65D932C432,S862HJT7DA5CJT876|sv|b|mb|p|mb|1N|mb|p|mb|p|mb|p|pg||
pc|s3|pc|s2|pc|sA|pc|s7|pg||
pc|sT|pc|sQ|pc|sK|pc|s6|pg||
pc|sJ|pc|s8|pc|s4|pc|s5|pg||
pc|s9|pc|d5|pc|h8|pc|h9|pg||
pc|d9|pc|dA|pc|d6|pc|d8|pg||
pc|c6|pc|c9|pc|cQ|pc|c4|pg||
pc|cK|pc|c2|pc|c7|pc|h2|pg||
pc|cA|pc|c3|pc|c8|pc|d4|pg||
pc|dK|pc|d2|pc|h7|pc|dT|pg||
pc|c5|pc|h5|pc|cT|pc|h3|pg||
pc|cJ|mc|7|pg||
qx|o8|st||md|2SQJHQ4DQ98762CKQ5,SA632HKT86DJ3CJ84,ST954HJ92DAT54C76,SK87HA753DKCAT932|sv|o|mb|p|mb|p|mb|1C|mb|1D|mb|d|mb|3D|mb|3H|mb|p|mb|p|mb|p|pg||
pc|d6|pc|d3|pc|dA|pc|dK|pg||
pc|c7|pc|cA|pc|c5|pc|c4|pg||
pc|c2|pc|cQ|pc|cJ|pc|c6|pg||
pc|sQ|pc|sA|pc|s4|pc|s8|pg||
pc|c8|pc|d5|pc|c3|pc|cK|pg||
pc|sJ|pc|s2|pc|s9|pc|sK|pg||
pc|hA|pc|h4|pc|h6|pc|h2|pg||
pc|h3|pc|hQ|pc|hK|pc|h9|pg||
pc|dJ|pc|d4|pc|h5|pc|d2|pg||
pc|c9|pc|d7|pc|s3|pc|hJ|pg||
pc|sT|pc|s7|pc|d8|pc|s6|pg||
pc|s5|pc|h7|pc|d9|pc|h8|pg||
pc|hT|pc|dT|pc|cT|pc|dQ|pg||
pg||
qx|c8|st||md|2SQJHQ4DQ98762CKQ5,SA632HKT86DJ3CJ84,ST954HJ92DAT54C76,SK87HA753DKCAT932|sv|o|mb|p|mb|p|mb|1C|mb|1D|mb|d|mb|3D|mb|3H|mb|p|mb|4H|mb|p|mb|p|mb|p|pg||
pc|d6|pc|d3|pc|dA|pc|dK|pg||
pc|c7|pc|c3|pc|cQ|pc|c4|pg||
pc|sQ|pc|sA|pc|s4|pc|s8|pg||
pc|h6|pc|h9|pc|hA|pc|h4|pg||
pc|h3|pc|hQ|pc|hK|pc|h2|pg||
pc|cJ|pc|c6|pc|c2|pc|cK|pg||
pc|sJ|pc|s2|pc|s5|pc|sK|pg||
pc|c9|pc|c5|pc|c8|pc|hJ|pg||
pc|sT|pc|s7|pc|d2|pc|s3|pg||
mc|8|pg||
qx|o9|st||md|3S73HA9DAQJ32CK872,SQJ6HQ72DK986C543,ST954HJ654D54CQ96,SAK82HKT83DT7CAJT|sv|e|mb|p|mb|1N|mb|p|mb|2S|mb|p|mb|2N|mb|p|mb|p|mb|p|pg||
pc|dQ|pc|dK|pc|d4|pc|d7|pg||
pc|c3|pc|c6|pc|cJ|pc|c2|pg||
pc|h3|pc|h9|pc|hQ|pc|h4|pg||
pc|h2|pc|h5|pc|h8|pc|hA|pg||
pc|s3|pc|sQ|pc|s4|pc|s2|pg||
pc|h7|pc|h6|pc|hT|pc|d2|pg||
mc|10|pg||
qx|c9|st||md|3S73HA9DAQJ32CK872,SQJ6HQ72DK986C543,ST954HJ654D54CQ96,SAK82HKT83DT7CAJT|sv|e|mb|p|mb|1N|mb|p|mb|p|mb|p|pg||
pc|dQ|pc|dK|pc|d4|pc|dT|pg||
pc|d6|pc|d5|pc|d7|pc|d2|pg||
pc|h3|pc|h9|pc|hQ|pc|h4|pg||
pc|sQ|pc|s4|pc|s2|pc|s3|pg||
pc|sJ|pc|s5|pc|s8|pc|s7|pg||
pc|s6|pc|s9|pc|sA|pc|c2|pg||
pc|sK|pc|c7|pc|c3|pc|sT|pg||
pc|cA|pc|c8|pc|c5|pc|c6|pg||
mc|8|pg||
qx|o10|st||md|4S8HT962DA3CKJ9872,SAKT32HAKQ4DJT5CQ,SQ76H75DKQ864CT43,SJ954HJ83D972CA65|sv|b|mb|p|mb|p|mb|1S|mb|p|mb|2S|mb|3C|mb|3H|mb|p|mb|3S|mb|p|mb|4S|mb|p|mb|p|mb|p|pg||
pc|c3|pc|cA|pc|c2|pc|cQ|pg||
pc|s4|pc|s8|pc|sA|pc|s6|pg||
pc|sK|pc|s7|pc|s5|pc|c7|pg||
pc|h4|pc|h5|pc|hJ|pc|h2|pg||
pc|h3|pc|h6|pc|hK|pc|h7|pg||
pc|hA|pc|sQ|pc|h8|pc|h9|pg||
pc|d4|pc|d2|pc|dA|pc|d5|pg||
pc|d3|pc|dT|pc|dK|pc|d7|pg||
pc|dQ|pc|d9|pc|c8|pc|dJ|pg||
pc|d6|pc|sJ|pc|c9|pc|hQ|pg||
mc|9|pg||
qx|c10|st||md|4S8HT962DA3CKJ9872,SAKT32HAKQ4DJT5CQ,SQ76H75DKQ864CT43,SJ954HJ83D972CA65|sv|b|mb|p|mb|p|mb|1S|mb|p|mb|2S|mb|p|mb|3H|mb|p|mb|4S|mb|p|mb|p|mb|p|pg||
pc|dQ|pc|d2|pc|dA|pc|d5|pg||
pc|d3|pc|dJ|pc|dK|pc|d7|pg||
pc|d6|pc|d9|pc|s8|pc|dT|pg||
pc|h6|pc|hA|pc|h5|pc|h3|pg||
pc|sA|pc|s6|pc|s4|pc|c2|pg||
pc|sK|pc|s7|pc|s5|pc|c7|pg||
mc|9|pg||
qx|o11|st||md|1SA8432HQ2DQJ9C874,SKT97H4DT7643CQT2,SJHJT9873DK5CAJ63,SQ65HAK65DA82CK95|sv|o|mb|p|mb|p|mb|2D|mb|d|mb|2H|mb|2S|mb|p|mb|p|mb|p|pg||
pc|hJ|pc|hA|pc|h2|pc|h4|pg||
pc|s5|pc|s2|pc|sT|pc|sJ|pg||
pc|h7|pc|hK|pc|hQ|pc|c2|pg||
pc|dA|pc|d9|pc|d3|pc|d5|pg||
pc|d2|pc|dJ|pc|d7|pc|dK|pg||
pc|hT|pc|h5|pc|c4|pc|s7|pg||
pc|dT|pc|h3|pc|d8|pc|dQ|pg||
pc|sA|pc|s9|pc|c3|pc|s6|pg||
pc|s3|pc|sK|pc|c6|pc|sQ|pg||
pc|d6|pc|cJ|pc|h6|pc|s4|pg||
pc|c7|pc|cT|pc|cA|pc|c5|pg||
pc|h9|pc|c9|pc|c8|pc|d4|pg||
pc|h8|pc|cK|pc|s8|pc|cQ|pg||
pg||
qx|c11|st||md|1SA8432HQ2DQJ9C874,SKT97H4DT7643CQT2,SJHJT9873DK5CAJ63,SQ65HAK65DA82CK95|sv|o|mb|p|mb|p|mb|2H|mb|2N|mb|p|mb|p|mb|p|pg||
pc|hQ|pc|h4|pc|h3|pc|h5|pg||
pc|h2|pc|c2|pc|h7|pc|hA|pg||
pc|dA|pc|d9|pc|d3|pc|d5|pg||
pc|d2|pc|dJ|pc|d4|pc|dK|pg||
pc|h8|pc|hK|pc|s2|pc|s7|pg||
pc|d8|pc|dQ|pc|d6|pc|c3|pg||
pc|c8|pc|cT|pc|cA|pc|c5|pg||
pc|hJ|pc|h6|pc|c7|pc|s9|pg||
pc|hT|pc|s5|pc|s3|pc|sT|pg||
pc|h9|pc|c9|pc|c4|pc|d7|pg||
pc|sJ|pc|s6|pc|sA|pc|sK|pg||
mc|5|pg||
qx|o12|st||md|2SJHQJ6543DJT3CJ54,SQ874HT98DA952C87,S6532HK7DK764CK96,SAKT9HA2DQ8CAQT32|sv|n|mb|p|mb|p|mb|2N|mb|p|mb|3C|mb|p|mb|3S|mb|p|mb|4S|mb|p|mb|p|mb|p|pg||
pc|dJ|pc|d2|pc|dK|pc|d8|pg||
pc|hK|pc|hA|pc|h3|pc|h8|pg||
pc|dQ|pc|d3|pc|d5|pc|d6|pg||
pc|sA|pc|sJ|pc|s4|pc|s2|pg||
pc|cA|pc|c5|pc|c7|pc|c9|pg||
pc|c3|pc|cJ|pc|c8|pc|cK|pg||
pc|h7|pc|h2|pc|hJ|pc|h9|pg||
pc|hQ|pc|hT|pc|d4|pc|sT|pg||
pc|cQ|pc|c4|pc|d9|pc|c6|pg||
pc|sK|pc|h4|pc|s7|pc|s3|pg||
pc|s9|pc|h5|pc|sQ|pc|s6|pg||
pc|s8|pc|s5|pc|c2|pc|h6|pg||
pc|dA|pc|d7|pc|cT|pc|dT|pg||
pg||
qx|c12|st||md|2SJHQJ6543DJT3CJ54,SQ874HT98DA952C87,S6532HK7DK764CK96,SAKT9HA2DQ8CAQT32|sv|n|mb|p|mb|p|mb|2N|mb|p|mb|3C|mb|p|mb|3D|mb|p|mb|3H|mb|p|mb|4S|mb|p|mb|p|mb|p|pg||
pc|dT|pc|d2|pc|dK|pc|dQ|pg||
pc|hK|pc|hA|pc|h3|pc|h8|pg||
pc|d8|pc|d3|pc|d9|pc|d4|pg||
pc|dA|pc|d6|pc|h2|pc|dJ|pg||
pc|c7|pc|c9|pc|cT|pc|cJ|pg||
pc|hJ|pc|h9|pc|h7|pc|s9|pg||
pc|cA|pc|c4|pc|c8|pc|c6|pg||
pc|c2|pc|c5|pc|s7|pc|cK|pg||
pc|hT|pc|d7|pc|sT|pc|hQ|pg||
pc|c3|pc|sJ|pc|sQ|pc|s2|pg||
pc|d5|pc|s6|pc|sK|pc|h4|pg||
pc|cQ|pc|h5|pc|s8|pc|s3|pg||
pc|s4|pc|s5|pc|sA|pc|h6|pg||
pg||
qx|o13|st||md|3S5H862D754CAK6532,ST432HQT9DKJ62CJT,SKQ976HAJ5DA93CQ7,SAJ8HK743DQT8C984|sv|b|mb|1N|mb|p|mb|2S|mb|p|mb|3C|mb|p|mb|3S|mb|p|mb|3N|mb|p|mb|p|mb|p|pg||
pc|h3|pc|h2|pc|hQ|pc|hA|pg||
pc|cQ|pc|c8|pc|c2|pc|cT|pg||
pc|c7|pc|c4|pc|cA|pc|cJ|pg||
pc|cK|pc|sT|pc|d9|pc|c9|pg||
pc|c6|pc|s2|pc|d3|pc|d8|pg||
pc|c5|pc|hT|pc|s7|pc|dT|pg||
pc|c3|pc|s3|pc|s6|pc|h4|pg||
pc|s5|pc|s4|pc|sK|pc|sA|pg||
pc|dQ|pc|d4|pc|d2|pc|dA|pg||
pc|sQ|pc|sJ|pc|d5|pc|d6|pg||
pc|s9|pc|s8|pc|h6|pc|h9|pg||
pc|h5|pc|h7|pc|h8|pc|dJ|pg||
pc|d7|pc|dK|pc|hJ|pc|hK|pg||
pg||
qx|c13|st||md|3S5H862D754CAK6532,ST432HQT9DKJ62CJT,SKQ976HAJ5DA93CQ7,SAJ8HK743DQT8C984|sv|b|mb|1S|mb|p|mb|1N|mb|p|mb|2D|mb|p|mb|p|mb|p|pg||
pc|d8|pc|d4|pc|d2|pc|d9|pg||
pc|c7|pc|c4|pc|cA|pc|cT|pg||
pc|s5|pc|s4|pc|sK|pc|sA|pg||
pc|dQ|pc|d5|pc|d6|pc|dA|pg||
pc|s6|pc|s8|pc|d7|pc|s2|pg||
pc|c2|pc|cJ|pc|cQ|pc|c8|pg||
pc|d3|pc|dT|pc|c3|pc|dJ|pg||
pc|hT|pc|hJ|pc|hK|pc|h2|pg||
pc|h3|pc|h6|pc|h9|pc|hA|pg||
pc|sQ|pc|sJ|pc|c5|pc|s3|pg||
mc|7|pg||
qx|o14|st||md|4ST643HKQJTDJ82CQ4,SA9752HDQ73CKT863,SQHA87642DA6CJ972,SKJ8H953DKT954CA5|sv|o|mb|1D|mb|p|mb|1S|mb|2H|mb|d|mb|4H|mb|4S|mb|p|mb|p|mb|p|pg||
pc|hA|pc|h3|pc|hK|pc|s2|pg||
pc|d3|pc|d6|pc|dK|pc|d2|pg||
pc|d4|pc|d8|pc|d7|pc|dA|pg||
pc|h2|pc|h5|pc|hT|pc|s5|pg||
pc|sA|pc|sQ|pc|s8|pc|s3|pg||
pc|dQ|pc|h4|pc|d5|pc|dJ|pg||
pc|c3|pc|c2|pc|cA|pc|c4|pg||
pc|d9|pc|sT|pc|c6|pc|h7|pg||
pc|s4|pc|s7|pc|h6|pc|sJ|pg||
pc|sK|pc|s6|pc|s9|pc|h8|pg||
pc|dT|pc|hJ|pc|c8|pc|c7|pg||
pc|c5|pc|cQ|pc|cK|pc|c9|pg||
pc|cT|pc|cJ|pc|h9|pc|hQ|pg||
pg||
qx|c14|st||md|4ST643HKQJTDJ82CQ4,SA9752HDQ73CKT863,SQHA87642DA6CJ972,SKJ8H953DKT954CA5|sv|o|mb|1C|mb|p|mb|1H|mb|2H|mb|p|mb|2S|mb|3C|mb|3D|mb|p|mb|4H|mb|p|mb|p|mb|p|pg||
pc|h3|pc|hT|pc|s2|pc|h2|pg||
pc|s3|pc|s7|pc|sQ|pc|sK|pg||
pc|h5|pc|hJ|pc|c3|pc|h4|pg||
pc|s4|pc|sA|pc|h8|pc|s8|pg||
pc|c2|pc|c5|pc|cQ|pc|cK|pg||
pc|c6|pc|c9|pc|cA|pc|c4|pg||
pc|h9|pc|hQ|pc|s5|pc|h6|pg||
pc|s6|pc|s9|pc|hA|pc|sJ|pg||
pc|cJ|pc|d4|pc|d2|pc|c8|pg||
pc|c7|pc|d5|pc|hK|pc|cT|pg||
pc|sT|pc|d3|pc|d6|pc|d9|pg||
mc|10|pg||
qx|o15|st||md|1S854HAKJ9D62C6543,ST962HQ5DAT98CQJT,SAHT87643DQJ4CK97,SKQJ73H2DK753CA82|sv|n|mb|p|mb|p|mb|2D|mb|2S|mb|3H|mb|3S|mb|p|mb|p|mb|p|pg||
pc|hA|pc|h5|pc|h8|pc|h2|pg||
pc|hK|pc|hQ|pc|h7|pc|s7|pg||
pc|sQ|pc|s4|pc|s2|pc|sA|pg||
pc|c9|pc|cA|pc|c5|pc|cT|pg||
pc|sK|pc|s5|pc|s6|pc|h4|pg||
pc|sJ|pc|s8|pc|s9|pc|h3|pg||
pc|c8|pc|c4|pc|cJ|pc|cK|pg||
pc|c7|pc|c2|pc|c3|pc|cQ|pg||
pc|d8|pc|d4|pc|dK|pc|d2|pg||
pc|d3|pc|d6|pc|dA|pc|dJ|pg||
pc|d9|pc|dQ|pc|d5|pc|c6|pg||
pc|h6|pc|s3|pc|h9|pc|dT|pg||
pc|d7|pc|hJ|pc|sT|pc|hT|pg||
pg||
qx|c15|st||md|1S854HAKJ9D62C6543,ST962HQ5DAT98CQJT,SAHT87643DQJ4CK97,SKQJ73H2DK753CA82|sv|n|mb|p|mb|p|mb|p|mb|1S|mb|p|mb|2D|mb|p|mb|4S|mb|p|mb|p|mb|p|pg||
pc|hA|pc|h5|pc|h3|pc|h2|pg||
pc|hK|pc|hQ|pc|h7|pc|s7|pg||
pc|sQ|pc|s4|pc|s2|pc|sA|pg||
pc|c7|pc|c8|pc|c3|pc|cT|pg||
pc|sT|pc|h4|pc|s3|pc|s5|pg||
pc|s6|pc|h6|pc|sK|pc|s8|pg||
pc|d3|pc|d2|pc|dA|pc|d4|pg||
pc|cQ|pc|c9|pc|c2|pc|c4|pg||
pc|cJ|pc|cK|pc|cA|pc|c5|pg||
pc|dK|pc|d6|pc|d8|pc|dJ|pg||
pc|d5|pc|h9|pc|d9|pc|dQ|pg||
mc|10|pg||
qx|o16|st||md|2SK75HQ983D6CT8764,SQJT6H2DKQJ95CQJ5,SA9843HT76DAT4CK3,S2HAKJ54D8732CA92|sv|e|mb|1D|mb|1S|mb|2H|mb|2S|mb|p|mb|p|mb|d|mb|3S|mb|3N|mb|p|mb|p|mb|p|pg||
pc|s3|pc|s2|pc|sK|pc|s6|pg||
pc|s7|pc|sQ|pc|s4|pc|h4|pg||
pc|dQ|pc|d4|pc|d2|pc|d6|pg||
pc|dK|pc|dA|pc|d3|pc|c8|pg||
pc|sA|pc|h5|pc|s5|pc|sT|pg||
pc|s8|pc|c2|pc|h3|pc|sJ|pg||
pc|cQ|pc|c3|pc|cA|pc|c4|pg||
pc|d8|pc|c6|pc|dJ|pc|dT|pg||
pc|d9|pc|h6|pc|d7|pc|c7|pg||
pc|d5|pc|h7|pc|c9|pc|cT|pg||
pc|h2|pc|hT|pc|hA|pc|h8|pg||
pc|hK|pc|h9|pc|c5|pc|s9|pg||
pc|hJ|pc|hQ|pc|cJ|pc|cK|pg||
pg||
qx|c16|st||md|2SK75HQ983D6CT8764,SQJT6H2DKQJ95CQJ5,SA9843HT76DAT4CK3,S2HAKJ54D8732CA92|sv|e|mb|1D|mb|1S|mb|2D|mb|2S|mb|p|mb|p|mb|3D|mb|p|mb|3N|mb|p|mb|p|mb|p|pg||
pc|s4|pc|s2|pc|sK|pc|s6|pg||
pc|s7|pc|sQ|pc|s3|pc|d2|pg||
pc|dQ|pc|d4|pc|d3|pc|d6|pg||
pc|dK|pc|dA|pc|d7|pc|c8|pg||
pc|h6|pc|hA|pc|h3|pc|h2|pg||
pc|d8|pc|h8|pc|dJ|pc|dT|pg||
pc|d9|pc|s8|pc|h4|pc|c4|pg||
pc|d5|pc|s9|pc|h5|pc|c6|pg||
pc|cJ|pc|cK|pc|cA|pc|c7|pg||
pc|hK|pc|h9|pc|sT|pc|h7|pg||
pc|c2|pc|cT|pc|cQ|pc|c3|pg||
pc|c5|pc|hT|pc|c9|pc|s5|pg||
pc|hJ|pc|hQ|pc|sJ|pc|sA|pg||
pg||