vg|41st WBTC-BBO2,BB-SF4,I,17,32,USA1,65,MONACO,114|
rs|6CW-1,5CW-2,3DWx-1,3DWx-2,3NN=,5DN=,4HW+1,4HW+1,3CWx-2,3NN+2,4SW=,5SE-1,6CN-3,3NS=,4SS-1,4SN-1,3NE-1,4SE=,2SN=,2HW+4,1NN-2,1NN-3,PASS,2SW-1,3HNx-1,3NE=,4HS=,4HS=,4HW=,4CN-2,4SW=,4SW=|
pn|BATHURST,MULTON,DWYER,ZIMMERMANN,NUNES,WEINSTEIN,FANTONI,LEVIN|pg||
qx|o17|st||md|3S9652H3DT98742CK9,SJT84HKQTDA3CQJ53,SAKQ73HAJ764D6C62,SH9852DKQJ5CAT874|sv|o|mb|1S|mb|d|mb|4S|mb|d|mb|p|mb|4N|mb|p|mb|6C|mb|p|mb|p|mb|p|pg||
pc|hA|pc|h2|pc|h3|pc|hT|pg||
pc|h7|pc|h5|pc|c9|pc|hQ|pg||
pc|dT|pc|dA|pc|d6|pc|d5|pg||
pc|cQ|pc|c2|pc|cA|pc|cK|pg||
pc|cT|mc|11|pg||
qx|c17|st||md|3S9652H3DT98742CK9,SJT84HKQTDA3CQJ53,SAKQ73HAJ764D6C62,SH9852DKQJ5CAT874|sv|o|mb|1S|mb|d|mb|4S|mb|5C|mb|p|mb|p|mb|p|pg||
pc|sA|pc|c4|pc|s2|pc|s4|pg||
pc|d5|pc|d2|pc|dA|pc|d6|pg||
pc|cQ|pc|c2|pc|c7|pc|cK|pg||
pc|d4|pc|d3|pc|c6|pc|dJ|pg||
pc|hA|pc|h2|pc|h3|pc|hT|pg||
pc|h6|pc|h8|pc|c9|pc|hQ|pg||
mc|9|pg||
qx|o18|st||md|4ST9HJ52DQT632CJT2,SAQ52HKT76DA94C75,SKJ743HA43DCAK986,S86HQ98DKJ875CQ43|sv|n|mb|p|mb|p|mb|1D|mb|1S|mb|3D|mb|p|mb|p|mb|d|mb|p|mb|p|mb|p|pg||
pc|cK|pc|c3|pc|cJ|pc|c7|pg||
pc|cA|pc|c4|pc|c2|pc|c5|pg||
pc|hA|pc|h8|pc|h2|pc|h6|pg||
pc|h4|pc|h9|pc|hJ|pc|hK|pg||
pc|d4|pc|s3|pc|dK|pc|d2|pg||
pc|d5|pc|d3|pc|d9|pc|c9|pg||
pc|h7|pc|h3|pc|hQ|pc|h5|pg||
pc|cQ|pc|cT|pc|s2|pc|c6|pg||
pc|s6|pc|s9|pc|sA|pc|s4|pg||
pc|dA|pc|s7|pc|d7|pc|d6|pg||
pc|hT|pc|c8|pc|s8|pc|dT|pg||
pc|dQ|pc|s5|pc|sJ|pc|d8|pg||
pc|sT|pc|sQ|pc|sK|pc|dJ|pg||
pg||
qx|c18|st||md|4ST9HJ52DQT632CJT2,SAQ52HKT76DA94C75,SKJ743HA43DCAK986,S86HQ98DKJ875CQ43|sv|n|mb|p|mb|p|mb|1D|mb|1S|mb|3D|mb|p|mb|p|mb|d|mb|p|mb|p|mb|p|pg||
pc|cA|pc|c3|pc|cJ|pc|c5|pg||
pc|cK|pc|c4|pc|c2|pc|c7|pg||
pc|c9|pc|cQ|pc|cT|pc|s2|pg||
pc|h8|pc|h2|pc|hK|pc|hA|pg||
pc|h4|pc|h9|pc|hJ|pc|h7|pg||
pc|sT|pc|sA|pc|s3|pc|s6|pg||
pc|h6|pc|h3|pc|hQ|pc|h5|pg||
pc|dJ|pc|dQ|pc|dA|pc|s4|pg||
mc|7|pg||
qx|o19|st||md|1SK72H5DQ984CAQ864,SQT94HAK6DJ32CK75,SA863HQ83DAKT76CT,SJ5HJT9742D5CJ932|sv|e|mb|1D|mb|d|mb|1H|mb|p|mb|1S|mb|p|mb|3N|mb|p|mb|p|mb|p|pg||
pc|hJ|pc|h5|pc|hK|pc|h3|pg||
pc|s4|pc|s3|pc|sJ|pc|s2|pg||
pc|s5|pc|sK|pc|sT|pc|s6|pg||
pc|d4|pc|d2|pc|dK|pc|d5|pg||
pc|d6|pc|h2|pc|dQ|pc|d3|pg||
pc|d8|pc|dJ|pc|dA|pc|h4|pg||
pc|dT|pc|h7|pc|d9|pc|c7|pg||
pc|d7|pc|c2|pc|c4|pc|h6|pg||
pc|sA|pc|c3|pc|s7|pc|s9|pg||
pc|s8|pc|h9|pc|c6|pc|sQ|pg||
pc|hA|pc|h8|pc|hT|pc|c8|pg||
pc|c5|pc|cT|pc|c9|pc|cQ|pg||
pc|cA|pc|cK|pc|hQ|pc|cJ|pg||
pg||
qx|c19|st||md|1SK72H5DQ984CAQ864,SQT94HAK6DJ32CK75,SA863HQ83DAKT76CT,SJ5HJT9742D5CJ932|sv|e|mb|2C|mb|p|mb|2D|mb|p|mb|2S|mb|p|mb|2N|mb|p|mb|3D|mb|p|mb|5D|mb|p|mb|p|mb|p|pg||
pc|hJ|pc|h5|pc|hK|pc|h3|pg||
pc|s9|pc|sA|pc|s5|pc|s2|pg||
pc|h8|pc|h2|pc|d4|pc|h6|pg||
pc|sK|pc|s4|pc|s3|pc|sJ|pg||
pc|s7|pc|sQ|pc|s6|pc|hT|pg||
pc|sT|pc|s8|pc|h4|pc|d8|pg||
pc|cA|pc|c5|pc|cT|pc|c2|pg||
pc|c4|pc|c7|pc|d6|pc|c3|pg||
pc|hQ|pc|h7|pc|d9|pc|hA|pg||
pc|dQ|pc|d2|pc|d7|pc|d5|pg||
pc|c6|pc|cK|pc|dT|pc|c9|pg||
mc|11|pg||
qx|o20|st||md|2S854H96DKT86CA952,SAK9HAKQJTDA9CKT4,SJ76H74DQJ74CQ863,SQT32H8532D532CJ7|sv|b|mb|2C|mb|p|mb|2D|mb|p|mb|2H|mb|p|mb|2S|mb|p|mb|2N|mb|p|mb|3C|mb|p|mb|3H|mb|p|mb|4H|mb|p|mb|p|mb|p|pg||
pc|dJ|pc|d2|pc|d6|pc|dA|pg||
pc|hA|pc|h7|pc|h2|pc|h6|pg||
pc|hK|pc|h4|pc|h3|pc|h9|pg||
pc|sK|pc|s7|pc|s2|pc|s5|pg||
pc|sA|pc|s6|pc|s3|pc|s8|pg||
pc|s9|pc|sJ|pc|sQ|pc|s4|pg||
pc|sT|pc|c2|pc|d9|pc|c3|pg||
pc|c7|pc|c5|pc|cT|pc|cQ|pg||
mc|11|pg||
qx|c20|st||md|2S854H96DKT86CA952,SAK9HAKQJTDA9CKT4,SJ76H74DQJ74CQ863,SQT32H8532D532CJ7|sv|b|mb|2C|mb|p|mb|2D|mb|p|mb|2H|mb|p|mb|2S|mb|p|mb|2N|mb|p|mb|3C|mb|p|mb|3H|mb|p|mb|4H|mb|p|mb|p|mb|p|pg||
pc|dQ|pc|d2|pc|d6|pc|dA|pg||
pc|hA|pc|h4|pc|h3|pc|h6|pg||
pc|hK|pc|h7|pc|h2|pc|h9|pg||
pc|sK|pc|s7|pc|s2|pc|s4|pg||
pc|sA|pc|s6|pc|s3|pc|s5|pg||
pc|s9|pc|sJ|pc|sQ|pc|s8|pg||
pc|sT|pc|c2|pc|d9|pc|d4|pg||
pc|cJ|pc|c5|pc|c4|pc|cQ|pg||
mc|11|pg||
qx|o21|st||md|3SAJTHAK9D963C6532,S9HQ532DJ7CAQJT84,SK765HJT74DAKQ2C9,SQ8432H86DT854CK7|sv|n|mb|1D|mb|p|mb|2N|mb|3C|mb|d|mb|p|mb|p|mb|p|pg||
pc|dK|pc|d4|pc|d9|pc|d7|pg||
pc|c9|pc|cK|pc|c6|pc|c8|pg||
pc|h6|pc|hK|pc|h2|pc|h4|pg||
pc|c3|pc|c4|pc|s5|pc|c7|pg||
pc|h8|pc|hA|pc|h3|pc|h7|pg||
pc|h9|pc|hQ|pc|hT|pc|s2|pg||
pc|cA|pc|s6|pc|s3|pc|c2|pg||
pc|cQ|pc|d2|pc|d5|pc|c5|pg||
pc|cJ|pc|dQ|pc|s4|pc|d3|pg||
pc|cT|pc|s7|pc|s8|pc|sJ|pg||
pc|dJ|pc|dA|pc|d8|pc|d6|pg||
pc|hJ|pc|dT|pc|sT|pc|h5|pg||
pc|sK|pc|sQ|pc|sA|pc|s9|pg||
pg||
qx|c21|st||md|3SAJTHAK9D963C6532,S9HQ532DJ7CAQJT84,SK765HJT74DAKQ2C9,SQ8432H86DT854CK7|sv|n|mb|1N|mb|p|mb|3N|mb|p|mb|p|mb|p|pg||
pc|s3|pc|sT|pc|s9|pc|s5|pg||
pc|d3|pc|d7|pc|dK|pc|d4|pg||
pc|s6|pc|s2|pc|sJ|pc|c4|pg||
pc|sA|pc|h5|pc|s7|pc|s4|pg||
pc|d6|pc|dJ|pc|dA|pc|d5|pg||
pc|sK|pc|s8|pc|c2|pc|h2|pg||
pc|hJ|pc|h6|pc|hK|pc|h3|pg||
pc|hA|pc|hQ|pc|h7|pc|h8|pg||
pc|h9|pc|c8|pc|hT|pc|c7|pg||
pc|h4|pc|sQ|pc|c3|pc|cQ|pg||
pc|dQ|pc|d8|pc|d9|pc|cT|pg||
mc|11|pg||
qx|o22|st||md|4SHK8543DT543CKJ94,SKJ8542HQD7CA8653,SA963HJT72DQ92CQ7,SQT7HA96DAKJ86CT2|sv|e|mb|1N|mb|2C|mb|4S|mb|p|mb|p|mb|p|pg||
pc|cQ|pc|c2|pc|c4|pc|cA|pg||
pc|c3|pc|c7|pc|cT|pc|cJ|pg||
pc|hK|pc|hQ|pc|h2|pc|hA|pg||
pc|dA|pc|d4|pc|d7|pc|d2|pg||
pc|dK|pc|d3|pc|c5|pc|d9|pg||
pc|h6|pc|h4|pc|s2|pc|h7|pg||
pc|c6|pc|hT|pc|s7|pc|c9|pg||
pc|d6|pc|d5|pc|s4|pc|dQ|pg||
pc|c8|pc|hJ|pc|sT|pc|cK|pg||
pc|sQ|pc|h3|pc|s5|pc|s3|pg||
pc|d8|pc|dT|pc|sJ|pc|s6|pg||
pc|s8|pc|s9|pc|h9|pc|h5|pg||
pc|sA|pc|dJ|pc|h8|pc|sK|pg||
pg||
qx|c22|st||md|4SHK8543DT543CKJ94,SKJ8542HQD7CA8653,SA963HJT72DQ92CQ7,SQT7HA96DAKJ86CT2|sv|e|mb|1N|mb|2H|mb|3D|mb|d|mb|4S|mb|4N|mb|5D|mb|p|mb|5S|mb|p|mb|p|mb|p|pg||
pc|d5|pc|d7|pc|dQ|pc|dA|pg||
pc|c2|pc|c9|pc|cA|pc|c7|pg||
pc|c3|pc|cQ|pc|cT|pc|c4|pg||
pc|h2|pc|hA|pc|h3|pc|hQ|pg||
pc|h6|pc|h4|pc|s2|pc|h7|pg||
pc|c5|pc|d2|pc|s7|pc|cJ|pg||
pc|dK|pc|d3|pc|c6|pc|d9|pg||
pc|h9|pc|h5|pc|s4|pc|hT|pg||
pc|c8|pc|hJ|pc|sT|pc|cK|pg||
pc|sQ|pc|d4|pc|s5|pc|s3|pg||
mc|10|pg||
qx|o23|st||md|1SA83HA5D9642CT853,SK72HQJT943DJT53C,S9H872DAKQ87CAKQ4,SQJT654HK6DCJ9762|sv|b|mb|p|mb|2D|mb|d|mb|3H|mb|p|mb|p|mb|4N|mb|p|mb|5H|mb|p|mb|6C|mb|p|mb|p|mb|p|pg||
pc|sQ|pc|sA|pc|s7|pc|s9|pg||
pc|c3|pc|hQ|pc|cA|pc|c6|pg||
pc|dA|pc|c2|pc|d2|pc|d3|pg||
pc|hK|pc|h5|pc|h3|pc|h2|pg||
pc|sJ|pc|s3|pc|s2|pc|c4|pg||
pc|h7|pc|h6|pc|hA|pc|h4|pg||
pc|d4|pc|dT|pc|dK|pc|c7|pg||
pc|s4|pc|s8|pc|sK|pc|cQ|pg||
pc|cK|pc|c9|pc|c5|pc|h9|pg||
pc|h8|pc|s5|pc|c8|pc|hT|pg||
pc|d9|pc|d5|pc|d7|pc|cJ|pg||
pc|s6|pc|cT|pc|hJ|pc|d8|pg||
pc|d6|pc|dJ|pc|dQ|pc|sT|pg||
pg||
qx|c23|st||md|1SA83HA5D9642CT853,SK72HQJT943DJT53C,S9H872DAKQ87CAKQ4,SQJT654HK6DCJ9762|sv|b|mb|p|mb|2H|mb|3D|mb|3H|mb|3N|mb|p|mb|p|mb|p|pg||
pc|hJ|pc|h2|pc|hK|pc|hA|pg||
pc|d2|pc|d5|pc|dA|pc|s4|pg||
pc|cA|pc|c2|pc|c3|pc|s7|pg||
pc|cK|pc|c6|pc|c5|pc|s2|pg||
pc|cQ|pc|c7|pc|c8|pc|h3|pg||
pc|s9|pc|sQ|pc|sA|pc|sK|pg||
pc|d4|pc|dJ|pc|dK|pc|s6|pg||
pc|h7|pc|h6|pc|h5|mc|9|pg||
qx|o24|st||md|2SAK9642HK9DT75C93,S853HJT64DA963C72,SQJHAQ8DQ82CKQJT8,ST7H7532DKJ4CA654|sv|o|mb|p|mb|1C|mb|p|mb|1S|mb|p|mb|1N|mb|p|mb|2C|mb|p|mb|2N|mb|p|mb|3S|mb|p|mb|4S|mb|p|mb|p|mb|p|pg||
pc|c7|pc|c8|pc|cA|pc|c3|pg||
pc|d4|pc|d5|pc|dA|pc|d2|pg||
pc|d3|pc|d8|pc|dJ|pc|d7|pg||
pc|dK|pc|dT|pc|d6|pc|dQ|pg||
pc|c4|pc|c9|pc|c2|pc|cT|pg||
pc|sJ|pc|s7|pc|s2|pc|s3|pg||
pc|sQ|pc|sT|pc|sA|mc|9|pg||
qx|c24|st||md|2SAK9642HK9DT75C93,S853HJT64DA963C72,SQJHAQ8DQ82CKQJT8,ST7H7532DKJ4CA654|sv|o|mb|p|mb|1C|mb|p|mb|1H|mb|p|mb|1N|mb|p|mb|2H|mb|p|mb|2S|mb|p|mb|4S|mb|p|mb|p|mb|p|pg||
pc|d4|pc|d5|pc|dA|pc|d8|pg||
pc|d3|pc|d2|pc|dJ|pc|d7|pg||
pc|dK|pc|dT|pc|d6|pc|dQ|pg||
pc|cA|mc|9|pg||
qx|o25|st||md|3SAQ7HA9DQ93CT7653,SKH763DAKJ4CAK942,S962HJT842D765CQ8,SJT8543HKQ5DT82CJ|sv|e|mb|2H|mb|p|mb|p|mb|3H|mb|p|mb|3N|mb|p|mb|p|mb|p|pg||
pc|hA|pc|h3|pc|h2|pc|h5|pg||
pc|h9|pc|h6|pc|h4|pc|hK|pg||
pc|s3|pc|sA|pc|sK|pc|s6|pg||
pc|c3|pc|c2|pc|cQ|pc|cJ|pg||
pc|hT|pc|hQ|pc|s7|pc|h7|pg||
pc|dT|pc|dQ|pc|dA|pc|d6|pg||
pc|dK|pc|d5|pc|d8|pc|d3|pg||
pc|cA|pc|c8|pc|s4|pc|c5|pg||
pc|dJ|pc|d7|pc|d2|pc|d9|pg||
pc|d4|mc|8|pg||
qx|c25|st||md|3SAQ7HA9DQ93CT7653,SKH763DAKJ4CAK942,S962HJT842D765CQ8,SJT8543HKQ5DT82CJ|sv|e|mb|p|mb|p|mb|1N|mb|d|mb|2D|mb|3S|mb|p|mb|4C|mb|p|mb|4S|mb|p|mb|p|mb|p|pg||
pc|c7|pc|cA|pc|c8|pc|cJ|pg||
pc|sK|pc|s6|pc|s5|pc|sA|pg||
pc|c6|pc|c2|pc|cQ|pc|s4|pg||
pc|sT|pc|sQ|pc|h3|pc|s2|pg||
pc|hA|pc|h6|pc|h8|pc|h5|pg||
pc|h9|pc|h7|pc|h2|pc|hK|pg||
pc|sJ|pc|s7|pc|c4|pc|s9|pg||
mc|10|pg||
qx|o26|st||md|4SAJ6HT3DAQT86CT65,S542HQJDK5CAKQJ83,SKQT3H8754DJ94C74,S987HAK962D732C92|sv|b|mb|p|mb|1D|mb|1N|mb|p|mb|2D|mb|d|mb|p|mb|2S|mb|p|mb|p|mb|p|pg||
pc|hA|pc|h3|pc|hQ|pc|h5|pg||
pc|c9|pc|c5|pc|cA|pc|c4|pg||
pc|cK|pc|c7|pc|c2|pc|c6|pg||
pc|cQ|pc|sT|pc|h6|pc|cT|pg||
pc|d9|pc|d2|pc|dQ|pc|dK|pg||
pc|hJ|pc|h4|pc|hK|pc|hT|pg||
pc|h2|pc|sA|pc|d5|pc|h7|pg||
pc|sJ|pc|s2|pc|s3|pc|s7|pg||
pc|s6|pc|s4|pc|sQ|pc|s8|pg||
pc|sK|pc|s9|pc|d6|pc|s5|pg||
pc|dJ|pc|d3|pc|d8|pc|c3|pg||
pc|d4|pc|d7|pc|dA|pc|c8|pg||
pc|dT|pc|cJ|pc|h8|pc|h9|pg||
pg||
qx|c26|st||md|4SAJ6HT3DAQT86CT65,S542HQJDK5CAKQJ83,SKQT3H8754DJ94C74,S987HAK962D732C92|sv|b|mb|p|mb|p|mb|1N|mb|p|mb|2D|mb|d|mb|p|mb|p|mb|r|mb|p|mb|2H|mb|p|mb|p|mb|p|pg||
pc|d4|pc|d2|pc|dA|pc|d5|pg||
pc|d8|pc|dK|pc|dJ|pc|d3|pg||
pc|hJ|pc|h4|pc|h2|pc|h3|pg||
pc|hQ|pc|h5|pc|hA|pc|hT|pg||
mc|12|pg||
qx|o27|st||md|1SQ9HQ64D8732C8753,SA76HT975DJ4CQJT4,SKJ84HAJ32DA95CK9,ST532HK8DKQT6CA62|sv|o|mb|p|mb|p|mb|1N|mb|p|mb|p|mb|p|pg||
pc|dQ|pc|d2|pc|d4|pc|dA|pg||
pc|s4|pc|s2|pc|sQ|pc|sA|pg||
pc|dJ|pc|d5|pc|d6|pc|d3|pg||
pc|cQ|pc|cK|pc|cA|pc|c3|pg||
pc|dT|pc|d7|pc|s7|pc|d9|pg||
pc|dK|pc|d8|pc|s6|pc|h2|pg||
pc|c6|pc|c5|pc|cJ|pc|c9|pg||
pc|cT|pc|h3|pc|c2|pc|c7|pg||
pc|h5|pc|hA|pc|h8|pc|h4|pg||
pc|sK|pc|s3|pc|s9|pc|h7|pg||
pc|hJ|pc|hK|pc|h6|pc|h9|pg||
pc|s5|pc|c8|pc|c4|pc|s8|pg||
pc|sJ|pc|sT|pc|hQ|pc|hT|pg||
pg||
qx|c27|st||md|1SQ9HQ64D8732C8753,SA76HT975DJ4CQJT4,SKJ84HAJ32DA95CK9,ST532HK8DKQT6CA62|sv|o|mb|p|mb|p|mb|1C|mb|p|mb|1S|mb|p|mb|1N|mb|p|mb|p|mb|p|pg||
pc|dQ|pc|d2|pc|d4|pc|d5|pg||
pc|d6|pc|d3|pc|dJ|pc|dA|pg||
pc|s4|pc|s2|pc|sQ|pc|sA|pg||
pc|cQ|pc|cK|pc|cA|pc|c3|pg||
pc|dT|pc|d7|pc|s6|pc|d9|pg||
pc|dK|pc|d8|pc|s7|pc|h2|pg||
pc|c6|pc|c5|pc|cT|pc|c9|pg||
pc|cJ|pc|h3|pc|c2|pc|c7|pg||
pc|hT|pc|hJ|pc|hK|pc|h4|pg||
pc|h8|pc|h6|pc|h5|pc|hA|pg||
mc|4|pg||
qx|o28|st||md|2S65HQ32DA7653CAT6,SK8743HKJ8DKCJ853,SAQ9HT764DJ98CK92,SJT2HA95DQT42CQ74|sv|n|mb|p|mb|p|mb|p|mb|p|pg||
qx|c28|st||md|2S65HQ32DA7653CAT6,SK8743HKJ8DKCJ853,SAQ9HT764DJ98CK92,SJT2HA95DQT42CQ74|sv|n|mb|1S|mb|p|mb|2S|mb|p|mb|p|mb|p|pg||
pc|h4|pc|h9|pc|hQ|pc|hK|pg||
pc|dK|pc|d9|pc|d2|pc|dA|pg||
pc|h2|pc|h8|pc|hT|pc|hA|pg||
pc|sJ|pc|s5|pc|s3|pc|sQ|pg||
pc|h6|pc|h5|pc|h3|pc|hJ|pg||
pc|s4|pc|sA|pc|s2|pc|s6|pg||
pc|s9|pc|sT|pc|d3|pc|s7|pg||
pc|dQ|pc|d5|pc|c3|pc|d8|pg||
pc|c4|pc|c6|pc|cJ|pc|cK|pg||
pc|h7|pc|d4|pc|d6|pc|s8|pg||
pc|c5|pc|c2|pc|cQ|pc|cA|pg||
pc|cT|pc|c8|pc|c9|pc|c7|pg||
pc|d7|pc|sK|pc|dJ|pc|dT|pg||
pg||
qx|o29|st||md|3SA764H9DK984CKJ63,SJ953H2DAQ53CA854,SQT8HKJT8643D7CT2,SK2HAQ75DJT62CQ97|sv|b|mb|3H|mb|p|mb|p|mb|d|mb|p|mb|p|mb|p|pg||
pc|sK|pc|sA|pc|s5|pc|s8|pg||
pc|h9|pc|h2|pc|h3|pc|hQ|pg||
pc|s2|pc|s4|pc|sJ|pc|sQ|pg||
pc|hJ|pc|hA|pc|d4|pc|c5|pg||
pc|d6|pc|dK|pc|dA|pc|d7|pg||
pc|s3|pc|sT|pc|h5|pc|s6|pg||
pc|dJ|pc|d8|pc|d3|pc|h4|pg||
pc|hK|pc|h7|pc|c3|pc|d5|pg||
pc|hT|pc|d2|pc|s7|pc|c4|pg||
pc|h8|pc|dT|pc|d9|pc|s9|pg||
pc|c2|pc|c7|pc|cJ|pc|cA|pg||
pc|dQ|pc|h6|pc|c9|pc|c6|pg||
pc|cT|pc|cQ|pc|cK|pc|c8|pg||
pg||
qx|c29|st||md|3SA764H9DK984CKJ63,SJ953H2DAQ53CA854,SQT8HKJT8643D7CT2,SK2HAQ75DJT62CQ97|sv|b|mb|3H|mb|p|mb|p|mb|d|mb|p|mb|3N|mb|p|mb|p|mb|p|pg||
pc|h9|pc|h2|pc|hT|pc|hQ|pg||
pc|dJ|pc|dK|pc|dA|pc|d7|pg||
pc|c4|pc|c2|pc|c9|pc|cJ|pg||
pc|s4|pc|s3|pc|s8|pc|sK|pg||
pc|cQ|pc|cK|pc|cA|pc|cT|pg||
pc|c5|pc|h6|pc|c7|pc|c3|pg||
pc|s2|pc|s6|pc|s9|pc|sT|pg||
pc|hK|pc|hA|pc|c6|pc|s5|pg||
mc|9|pg||
qx|o30|st||md|4SHAQJ43DAT743CT85,SK7654HK82D8CKQ76,SAJT932H976D2CA42,SQ8HT5DKQJ965CJ93|sv|o|mb|3D|mb|3H|mb|p|mb|4H|mb|p|mb|p|mb|p|pg||
pc|d8|pc|d2|pc|dJ|pc|dA|pg||
pc|d3|pc|s4|pc|h6|pc|d5|pg||
pc|sA|pc|s8|pc|c5|pc|s5|pg||
pc|sJ|pc|sQ|pc|h3|pc|s6|pg||
pc|d4|pc|c7|pc|h7|pc|d6|pg||
pc|sT|pc|hT|pc|hJ|pc|s7|pg||
pc|dT|pc|cK|pc|h9|pc|d9|pg||
pc|s2|pc|dQ|pc|h4|pc|sK|pg||
pc|c8|pc|cQ|pc|cA|pc|c3|pg||
pc|s3|pc|h5|pc|d7|pc|h2|pg||
pc|dK|pc|cT|pc|c6|pc|c2|pg||
pc|cJ|pc|hQ|pc|hK|pc|c4|pg||
pc|h8|pc|s9|pc|c9|pc|hA|pg||
pg||
qx|c30|st||md|4SHAQJ43DAT743CT85,SK7654HK82D8CKQ76,SAJT932H976D2CA42,SQ8HT5DKQJ965CJ93|sv|o|mb|3D|mb|3H|mb|p|mb|4H|mb|p|mb|p|mb|p|pg||
pc|d8|pc|d2|pc|dJ|pc|dA|pg||
pc|d3|pc|s4|pc|h6|pc|d6|pg||
pc|sA|pc|s8|pc|c5|pc|s5|pg||
pc|s2|pc|sQ|pc|h3|pc|s6|pg||
pc|d4|pc|hK|pc|c2|pc|dK|pg||
pc|h2|pc|h7|pc|hT|pc|hA|pg||
pc|d7|pc|c6|pc|h9|pc|d5|pg||
pc|s3|pc|h5|pc|hJ|pc|s7|pg||
pc|hQ|pc|h8|pc|s9|pc|c3|pg||
mc|10|pg||
qx|o31|st||md|1SKJHQ642DJT643C74,S2HAJ985DA98752C3,SQ754H3DKCAKJT852,SAT9863HKT7DQCQ96|sv|n|mb|p|mb|1H|mb|3C|mb|3S|mb|p|mb|4D|mb|p|mb|4H|mb|p|mb|p|mb|p|pg||
pc|cK|pc|c6|pc|c4|pc|c3|pg||
pc|s7|pc|sA|pc|sJ|pc|s2|pg||
pc|sT|pc|sK|pc|h8|pc|s4|pg||
pc|dA|pc|dK|pc|dQ|pc|d3|pg||
pc|d2|pc|c2|pc|h7|pc|d4|pg||
pc|c9|pc|c7|pc|h5|pc|c5|pg||
pc|d5|pc|c8|pc|hT|pc|d6|pg||
pc|cQ|pc|dJ|pc|h9|pc|cT|pg||
pc|d7|pc|h3|pc|hK|pc|dT|pg||
pc|s9|pc|h2|pc|hJ|pc|s5|pg||
pc|hA|pc|cJ|pc|s3|pc|h4|pg||
pc|d9|pc|sQ|pc|s6|pc|h6|pg||
pc|hQ|pc|d8|pc|cA|pc|s8|pg||
pg||
qx|c31|st||md|1SKJHQ642DJT643C74,S2HAJ985DA98752C3,SQ754H3DKCAKJT852,SAT9863HKT7DQCQ96|sv|n|mb|p|mb|p|mb|1C|mb|2S|mb|d|mb|p|mb|3C|mb|p|mb|3D|mb|d|mb|4C|mb|p|mb|p|mb|p|pg||
pc|dQ|pc|d3|pc|dA|pc|dK|pg||
pc|s2|pc|s5|pc|sA|pc|sJ|pg||
pc|s8|pc|sK|pc|c3|pc|s4|pg||
pc|hA|pc|h3|pc|h7|pc|h2|pg||
pc|d7|pc|cJ|pc|cQ|pc|d4|pg||
pc|s6|pc|c7|pc|d5|pc|s7|pg||
mc|8|pg||
qx|o32|st||md|2SK65HJ973D9874CJ4,SAJ92HTDA652CQ973,SQ7HAK852DQTCT862,ST843HQ64DKJ3CAK5|sv|e|mb|1D|mb|1H|mb|d|mb|3H|mb|3S|mb|p|mb|4S|mb|p|mb|p|mb|p|pg||
pc|hK|pc|h4|pc|h3|pc|hT|pg||
pc|dT|pc|dK|pc|d4|pc|d2|pg||
pc|s3|pc|s5|pc|sJ|pc|sQ|pg||
pc|c6|pc|cA|pc|c4|pc|c3|pg||
pc|s4|pc|s6|pc|s9|pc|s7|pg||
pc|sA|pc|h2|pc|s8|pc|sK|pg||
pc|d5|pc|dQ|pc|d3|pc|d7|pg||
mc|10|pg||
qx|c32|st||md|2SK65HJ973D9874CJ4,SAJ92HTDA652CQ973,SQ7HAK852DQTCT862,ST843HQ64DKJ3CAK5|sv|e|mb|1D|mb|1H|mb|d|mb|3H|mb|p|mb|p|mb|3N|mb|p|mb|4S|mb|p|mb|p|mb|p|pg||
pc|hA|pc|h4|pc|h3|pc|hT|pg||
pc|c6|pc|cA|pc|c4|pc|c3|pg||
pc|s3|pc|s5|pc|sJ|pc|sQ|pg||
pc|c2|pc|cK|pc|cJ|pc|c7|pg||
pc|h6|pc|h7|pc|s2|pc|h2|pg||
pc|sA|pc|s7|pc|s4|pc|s6|pg||
pc|cQ|pc|c8|pc|c5|pc|d4|pg||
pc|dA|pc|dT|pc|d3|pc|d7|pg||
pc|d5|pc|dQ|pc|dK|pc|d8|pg||
mc|10|pg||