vg|BBO1-14th World Youth Teams,Juniors-F4,I,1,16,NETHERLANDS,126,ISRAEL,110|
rs|4HS=,4HS=,2SWx-5,2SEx-5,3CN-1,1SE=,3CS-2,3CS-2,6DWx+1,6DWx+1,1NW=,2HS=,2SN=,3SN-1,3HE+2,3HW=,3NW+1,5CE=,1NS+1,1NS+3,4SS-1,4SS=,1NS-3,1NW+1,4SS-1,4SS-1,3NE+1,3NE+2,3SE=,2SE-1,3NEx-1,3NE-1|
pn|HOP,MEYUCHAS,HELMICH,PADON,FISHER,WACKWITZ,GERSTNER,WESTERBEEK|pg||
qx|o1|st||md|3SAHKQ8765DK73CK82,SJ72HJ4DQT95CQJ74,SQT954HT93DAJC963,SK863HA2D8642CAT5|sv|o|mb|2S|mb|p|mb|2N!|mb|p|mb|3S!|mb|p|mb|4H|mb|p|mb|p|mb|p|pg||
pc|cQ|pc|c3|pc|cA|pc|c2|pg||
pc|cT|pc|cK|pc|c4|pc|c6|pg||
pc|d3|pc|d5|pc|dA|pc|d2|pg||
pc|h3|pc|h2|pc|hK|pc|h4|pg||
pc|dK|pc|dQ|pc|dJ|pc|d4|pg||
pc|d7|pc|d9|pc|h9|pc|d6|pg||
pc|hT|pc|hA|pc|h5|pc|hJ|pg||
mc|10|pg||
qx|c1|st||md|3SAHKQ8765DK73CK82,SJ72HJ4DQT95CQJ74,SQT954HT93DAJC963,SK863HA2D8642CAT5|sv|o|mb|p|mb|1C|mb|1H|mb|1S|mb|2H|mb|p|mb|4H|mb|p|mb|p|mb|p|pg||
pc|cQ|pc|c3|pc|cA|pc|c8|pg||
pc|cT|pc|cK|pc|c4|pc|c6|pg||
pc|d7|pc|d5|pc|dA|pc|d2|pg||
pc|h3|pc|h2|pc|hK|pc|h4|pg||
pc|dK|pc|d9|pc|dJ|pc|d4|pg||
pc|d3|pc|dT|pc|h9|pc|d6|pg||
pc|hT|pc|hA|pc|h5|pc|hJ|pg||
mc|10|pg||
qx|o2|st||md|4SQJT75HJ82DJ7CAT7,SAHQ954D832CJ9832,SKHAKT3DAKQ965CQ5,S986432H76DT4CK64|sv|n|mb|2D!|mb|p|mb|2S!|mb|d!|mb|p|mb|p|mb|p|pg||
pc|dA|pc|d4|pc|d7|pc|d3|pg||
pc|dK|pc|dT|pc|dJ|pc|d8|pg||
pc|dQ|pc|h6|pc|h8|pc|d2|pg||
pc|sK|pc|s2|pc|s5|pc|sA|pg||
pc|h4|pc|h3|pc|h7|pc|hJ|pg||
pc|h2|pc|h5|pc|hT|pc|s3|pg||
pc|c4|pc|c7|pc|c9|pc|cQ|pg||
pc|hA|pc|s9|pc|sT|pc|h9|pg||
pc|cA|pc|c2|pc|c5|pc|c6|pg||
pc|cT|pc|c3|pc|d5|pc|cK|pg||
mc|3|pg||
qx|c2|st||md|4SQJT75HJ82DJ7CAT7,SAHQ954D832CJ9832,SKHAKT3DAKQ965CQ5,S986432H76DT4CK64|sv|n|mb|2S|mb|p|mb|p|mb|d|mb|p|mb|p|mb|p|pg||
pc|dJ|pc|d2|pc|dQ|pc|d4|pg||
pc|dA|pc|dT|pc|d7|pc|d3|pg||
pc|dK|pc|h6|pc|h8|pc|d8|pg||
pc|c5|pc|cK|pc|cA|pc|c2|pg||
pc|s5|pc|sA|pc|sK|pc|s2|pg||
pc|h4|pc|hK|pc|h7|pc|hJ|pg||
pc|cQ|pc|c4|pc|cT|pc|c3|pg||
pc|d9|pc|s9|pc|sT|pc|h5|pg||
pc|h2|pc|h9|pc|hT|pc|s3|pg||
pc|c6|pc|c7|pc|cJ|pc|h3|pg||
mc|3|pg||
qx|o3|st||md|1S8754HJ72D976CK75,SKT63HKT3DKT532C6,S9HAQ98DAJ4CA9842,SAQJ2H654DQ8CQJT3|sv|e|mb|p|mb|p|mb|1C|mb|p|mb|p|mb|d|mb|1H|mb|1S|mb|2C|mb|2S|mb|3C|mb|p|mb|p|mb|p|pg||
pc|cJ|pc|c5|pc|c6|pc|cA|pg||
pc|hQ|pc|h4|pc|h2|pc|hK|pg||
pc|d5|pc|d4|pc|dQ|pc|d6|pg||
pc|sA|pc|s4|pc|s3|pc|s9|pg||
pc|s2|pc|s5|pc|sK|pc|c2|pg||
pc|c4|pc|cQ|pc|cK|pc|d2|pg||
pc|d7|pc|d3|pc|dJ|pc|d8|pg||
pc|dA|pc|c3|pc|d9|pc|dT|pg||
pc|cT|pc|c7|pc|dK|pc|c8|pg||
pc|sQ|pc|s7|pc|s6|pc|c9|pg||
pc|h8|pc|h6|pc|hJ|pc|h3|pg||
pc|h7|pc|hT|pc|hA|pc|h5|pg||
pc|h9|pc|sJ|pc|s8|pc|sT|pg||
pg||
qx|c3|st||md|1S8754HJ72D976CK75,SKT63HKT3DKT532C6,S9HAQ98DAJ4CA9842,SAQJ2H654DQ8CQJT3|sv|e|mb|p|mb|p|mb|1C|mb|p|mb|p|mb|d|mb|p|mb|1S|mb|p|mb|p|mb|p|pg||
pc|s4|pc|s3|pc|s9|pc|sA|pg||
pc|s2|pc|s5|pc|s6|pc|c2|pg||
pc|d2|pc|d4|pc|dQ|pc|d6|pg||
pc|d8|pc|d7|pc|d3|pc|dJ|pg||
pc|c4|pc|cJ|pc|cK|pc|c6|pg||
pc|s7|pc|sK|pc|h8|pc|sQ|pg||
pc|dK|pc|dA|pc|sJ|pc|d9|pg||
pc|cQ|pc|c5|pc|h3|pc|cA|pg||
pc|c9|pc|cT|pc|c7|pc|d5|pg||
pc|c3|pc|h2|pc|sT|pc|c8|pg||
pc|dT|pc|h9|pc|h4|pc|s8|pg||
pc|h7|pc|hT|pc|hQ|pc|h5|pg||
pc|hA|pc|h6|pc|hJ|pc|hK|pg||
pg||
qx|o4|st||md|2SA72HJT54D75CKQ87,SJ64HAK976D43CA94,SK953H3DAKT82C532,SQT8HQ82DQJ96CJT6|sv|b|mb|1H|mb|p|mb|2H|mb|p|mb|p|mb|d!|mb|p|mb|3C|mb|p|mb|p|mb|p|pg||
pc|hA|pc|h3|pc|h2|pc|h4|pg||
pc|d4|pc|dA|pc|d6|pc|d5|pg||
pc|c2|pc|c6|pc|cK|pc|cA|pg||
pc|c4|pc|c5|pc|cT|pc|cQ|pg||
pc|d7|pc|d3|pc|dK|pc|d9|pg||
pc|d2|pc|dJ|pc|c7|pc|c9|pg||
pc|s4|pc|s3|pc|sQ|pc|sA|pg||
pc|h5|pc|h6|pc|c3|pc|hQ|pg||
pc|d8|pc|dQ|pc|c8|pc|h7|pg||
pc|s2|pc|s6|pc|sK|pc|s8|pg||
pc|dT|pc|cJ|pc|s7|pc|h9|pg||
pc|h8|pc|hT|pc|hK|pc|s5|pg||
pc|sJ|pc|s9|pc|sT|pc|hJ|pg||
pg||
qx|c4|st||md|2SA72HJT54D75CKQ87,SJ64HAK976D43CA94,SK953H3DAKT82C532,SQT8HQ82DQJ96CJT6|sv|b|mb|1H|mb|p|mb|2H|mb|p|mb|p|mb|d|mb|p|mb|3C|mb|p|mb|p|mb|p|pg||
pc|c4|pc|c2|pc|cT|pc|cK|pg||
pc|d7|pc|d3|pc|dK|pc|d6|pg||
pc|h3|pc|h8|pc|hJ|pc|hK|pg||
pc|d4|pc|dA|pc|d9|pc|d5|pg||
pc|d2|pc|dJ|pc|c8|pc|c9|pg||
pc|cA|pc|c3|pc|c6|pc|c7|pg||
pc|sJ|pc|s3|pc|sQ|pc|sA|pg||
pc|s7|pc|s4|pc|s9|pc|sT|pg||
pc|cJ|pc|cQ|pc|h6|pc|c5|pg||
pc|s2|pc|s6|pc|sK|pc|s8|pg||
pc|s5|pc|h2|pc|h4|pc|h7|pg||
pc|d8|pc|dQ|pc|h5|pc|h9|pg||
pc|hQ|pc|hT|pc|hA|pc|dT|pg||
pg||
qx|o5|st||md|3SAQJT93HA93DCT986,S854H7DAQ87532CAQ,SK72HKQJT864DT9C3,S6H52DKJ64CKJ7542|sv|n|mb|3H|mb|p|mb|4H|mb|5D|mb|p|mb|p|mb|5H|mb|p|mb|p|mb|6D|mb|p!|mb|p|mb|d|mb|p|mb|p|mb|p|pg||
pc|c3|pc|c2|pc|c6|pc|cQ|pg||
pc|dA|pc|d9|pc|d4|pc|h3|pg||
mc|13|pg||
qx|c5|st||md|3SAQJT93HA93DCT986,S854H7DAQ87532CAQ,SK72HKQJT864DT9C3,S6H52DKJ64CKJ7542|sv|n|mb|3H|mb|p|mb|4H|mb|5D|mb|p|mb|p|mb|5H|mb|p|mb|p|mb|6D|mb|d|mb|p|mb|p|mb|p|pg||
pc|c3|pc|c2|pc|c6|pc|cQ|pg||
mc|13|pg||
qx|o6|st||md|4SQ8HAKTDKT7432C76,SAJ9HJ6DA986CAK84,SKT52HQ9754D5C932,S7643H832DQJCQJT5|sv|e|mb|p|mb|1D|mb|1N|mb|p|mb|p|mb|p|pg||
pc|h4|pc|h2|pc|hK|pc|h6|pg||
pc|hA|pc|hJ|pc|h9|pc|h3|pg||
pc|s8|pc|s9|pc|sT|pc|s3|pg||
pc|hQ|pc|h8|pc|hT|pc|c4|pg||
pc|h7|pc|s4|pc|d4|pc|d6|pg||
pc|h5|pc|s6|pc|d2|pc|sJ|pg||
pc|c9|pc|c5|pc|c6|pc|cK|pg||
pc|cA|pc|c2|pc|cT|pc|c7|pg||
pc|c8|pc|c3|pc|cQ|pc|d3|pg||
pc|cJ|pc|d7|pc|d8|pc|s2|pg||
pc|dQ|pc|dT|pc|d9|pc|d5|pg||
pc|dJ|pc|dK|pc|dA|pc|s5|pg||
pc|sA|pc|sK|pc|s7|pc|sQ|pg||
pg||
qx|c6|st||md|4SQ8HAKTDKT7432C76,SAJ9HJ6DA986CAK84,SKT52HQ9754D5C932,S7643H832DQJCQJT5|sv|e|mb|p|mb|1D|mb|1N|mb|2C|mb|p|mb|2H|mb|p|mb|p|mb|p|pg||
pc|cA|pc|c2|pc|cQ|pc|c6|pg||
pc|cK|pc|c3|pc|c5|pc|c7|pg||
pc|hJ|pc|h4|pc|h2|pc|hA|pg||
pc|d3|pc|d6|pc|d5|pc|dJ|pg||
pc|h3|pc|hT|pc|h6|pc|hQ|pg||
pc|c9|pc|cJ|pc|hK|pc|c4|pg||
pc|s8|pc|s9|pc|sK|pc|s3|pg||
pc|h9|pc|h8|pc|d2|pc|d8|pg||
pc|s2|pc|s4|pc|sQ|pc|sA|pg||
pc|c8|pc|h5|pc|cT|pc|d4|pg||
pc|s5|pc|s6|pc|d7|pc|sJ|pg||
pc|dA|pc|h7|pc|dQ|pc|dT|pg||
pc|sT|pc|s7|pc|dK|pc|d9|pg||
pg||
qx|o7|st||md|1S2H98643DT742CAJ8,SKJ4HKJ72D83C9752,SAT9753HA5DK5CKQ6,SQ86HQTDAQJ96CT43|sv|b|mb|p|mb|p|mb|1S|mb|p|mb|1N|mb|p|mb|2C!|mb|p|mb|2H|mb|p|mb|2S|mb|p|mb|p|mb|p|pg||
pc|c3|pc|c8|pc|c9|pc|cK|pg||
pc|sA|pc|s6|pc|s2|pc|s4|pg||
pc|s3|pc|s8|pc|h3|pc|sJ|pg||
pc|d8|pc|dK|pc|dA|pc|d2|pg||
pc|dQ|pc|d4|pc|d3|pc|d5|pg||
pc|d6|pc|dT|pc|sK|pc|h5|pg||
mc|8|pg||
qx|c7|st||md|1S2H98643DT742CAJ8,SKJ4HKJ72D83C9752,SAT9753HA5DK5CKQ6,SQ86HQTDAQJ96CT43|sv|b|mb|p|mb|p|mb|1S|mb|p|mb|1N|mb|p|mb|3S|mb|p|mb|p|mb|p|pg||
pc|c3|pc|c8|pc|c2|pc|cQ|pg||
pc|sA|pc|s6|pc|s2|pc|s4|pg||
pc|s5|pc|s8|pc|h3|pc|sJ|pg||
pc|d3|pc|dK|pc|dA|pc|d2|pg||
pc|dQ|pc|d4|pc|d8|pc|d5|pg||
pc|d6|pc|d7|pc|sK|pc|h5|pg||
mc|8|pg||
qx|o8|st||md|2SAQ54HKDKJT76CKT8,SK982HQ542D9CAQ74,ST7H863DA843C9532,SJ63HAJT97DQ52CJ6|sv|o|mb|1C|mb|p|mb|1H!|mb|d|mb|2H|mb|3D|mb|3H|mb|p|mb|p|mb|p|pg||
pc|dJ|pc|d9|pc|dA|pc|d5|pg||
pc|sT|pc|sJ|pc|s4|pc|s2|pg||
pc|d2|pc|d6|pc|h2|pc|d3|pg||
pc|h4|pc|h3|pc|hA|pc|hK|pg||
pc|dQ|pc|dK|pc|hQ|pc|d4|pg||
pc|h5|pc|h6|pc|hJ|pc|d7|pg||
pc|hT|pc|dT|pc|c4|pc|h8|pg||
pc|s3|pc|sA|pc|s8|pc|s7|pg||
pc|sQ|pc|sK|pc|c2|pc|s6|pg||
pc|s9|pc|c3|pc|h7|pc|s5|pg||
pc|cJ|pc|cK|pc|cA|pc|c5|pg||
pc|cQ|pc|c9|pc|c6|pc|c8|pg||
pc|c7|pc|d8|pc|h9|pc|cT|pg||
pg||
qx|c8|st||md|2SAQ54HKDKJT76CKT8,SK982HQ542D9CAQ74,ST7H863DA843C9532,SJ63HAJT97DQ52CJ6|sv|o|mb|1C|mb|p|mb|1D|mb|d|mb|2H|mb|p|mb|p|mb|d|mb|p|mb|3D|mb|3H|mb|p|mb|p|mb|p|pg||
pc|h3|pc|h9|pc|hK|pc|h2|pg||
pc|dT|pc|d9|pc|dA|pc|d2|pg||
pc|d3|pc|d5|pc|dJ|pc|h4|pg||
pc|h5|pc|h6|pc|hT|pc|d7|pg||
pc|cJ|pc|cK|pc|cA|pc|c2|pg||
pc|cQ|pc|c3|pc|c6|pc|c8|pg||
pc|c4|pc|c5|pc|h7|pc|cT|pg||
pc|s3|pc|s4|pc|sK|pc|s7|pg||
pc|c7|pc|c9|pc|hJ|pc|d6|pg||
mc|9|pg||
qx|o9|st||md|3SAQT4HK4DK973CQ73,S9HQJ76DAQT8CA652,SJ863HT8532D64C94,SK752HA9DJ52CKJT8|sv|e|mb|p|mb|1C|mb|p|mb|1H!|mb|p|mb|1S|mb|p|mb|3N|mb|p|mb|p|mb|p|pg||
pc|c9|pc|cJ|pc|cQ|pc|cA|pg||
pc|c5|pc|c4|pc|cK|pc|c7|pg||
pc|d2|pc|d3|pc|dQ|pc|d4|pg||
pc|hQ|pc|h5|pc|h9|pc|hK|pg||
pc|c3|pc|c6|pc|h2|pc|cT|pg||
pc|hA|pc|h4|pc|h6|pc|h3|pg||
pc|c8|pc|s4|pc|c2|pc|s3|pg||
pc|dJ|pc|dK|pc|dA|pc|d6|pg||
pc|dT|pc|s6|pc|d5|pc|d7|pg||
pc|hJ|pc|h8|pc|s2|pc|sT|pg||
pc|d8|pc|hT|pc|s5|pc|d9|pg||
pc|sA|pc|s9|pc|s8|pc|s7|pg||
pc|sQ|pc|h7|pc|sJ|pc|sK|pg||
pg||
qx|c9|st||md|3SAQT4HK4DK973CQ73,S9HQJ76DAQT8CA652,SJ863HT8532D64C94,SK752HA9DJ52CKJT8|sv|e|mb|p|mb|1C|mb|1S|mb|d|mb|3S|mb|p|mb|p|mb|d|mb|p|mb|4C|mb|p|mb|5C|mb|p|mb|p|mb|p|pg||
pc|sA|pc|s9|pc|s3|pc|s5|pg||
pc|d3|pc|d8|pc|d4|pc|d2|pg||
pc|cA|pc|c4|pc|c8|pc|c3|pg||
pc|c2|pc|c9|pc|cK|pc|c7|pg||
pc|dJ|pc|d7|pc|dT|pc|d6|pg||
pc|d5|pc|d9|pc|dQ|pc|s6|pg||
pc|dA|pc|h2|pc|h9|pc|dK|pg||
pc|h6|pc|h3|pc|hA|pc|h4|pg||
pc|sK|pc|s4|pc|h7|pc|s8|pg||
pc|s2|pc|sT|pc|c5|pc|sJ|pg||
pc|hJ|pc|h5|pc|cT|pc|hK|pg||
pc|s7|pc|sQ|pc|c6|pc|h8|pg||
pc|hQ|pc|hT|pc|cJ|pc|cQ|pg||
pg||
qx|o10|st||md|4SQT3HJ876DAK764C5,S962HQ5432DQCKQ72,SA754HAT9DT3CAJ64,SKJ8HKDJ9852CT983|sv|b|mb|p|mb|p|mb|p|mb|1C|mb|p|mb|1D|mb|p|mb|1S|mb|p|mb|1N|mb|p|mb|p|mb|p|pg||
pc|h3|pc|h9|pc|hK|pc|h6|pg||
pc|cT|pc|c5|pc|cK|pc|c4|pg||
pc|c2|pc|c6|pc|c9|pc|d4|pg||
pc|s8|pc|sQ|pc|s2|pc|s4|pg||
pc|h7|pc|h2|pc|hT|pc|d2|pg||
pc|s5|pc|sK|pc|s3|pc|s6|pg||
pc|sJ|pc|sT|pc|s9|pc|sA|pg||
pc|hA|pc|d5|pc|h8|pc|h4|pg||
pc|s7|pc|c3|pc|d6|pc|h5|pg||
pc|cA|pc|c8|pc|hJ|pc|c7|pg||
pc|d3|pc|d8|pc|dA|pc|dQ|pg||
pc|dK|pc|cQ|pc|dT|pc|d9|pg||
pc|d7|pc|hQ|pc|cJ|pc|dJ|pg||
pg||
qx|c10|st||md|4SQT3HJ876DAK764C5,S962HQ5432DQCKQ72,SA754HAT9DT3CAJ64,SKJ8HKDJ9852CT983|sv|b|mb|p|mb|p|mb|p|mb|1C|mb|p|mb|1H|mb|p|mb|1S|mb|p|mb|1N|mb|p|mb|p|mb|p|pg||
pc|s6|pc|s4|pc|sK|pc|s3|pg||
pc|sJ|pc|sQ|pc|s2|pc|s5|pg||
pc|h6|pc|h5|pc|h9|pc|hK|pg||
pc|s8|pc|sT|pc|s9|pc|s7|pg||
pc|h7|pc|h2|pc|hT|pc|d5|pg||
pc|sA|pc|d2|pc|h8|pc|c2|pg||
pc|d3|pc|d8|pc|d4|pc|dQ|pg||
pc|h3|pc|hA|pc|c3|pc|hJ|pg||
pc|cA|pc|c8|pc|c5|pc|c7|pg||
pc|dT|pc|d9|pc|dA|mc|10|pg||
qx|o11|st||md|1SKQ854HAK7DA4CT63,SA2HT32DKJ853CA85,ST97HDQT972CKQJ97,SJ63HQJ98654D6C42|sv|o|mb|1S|mb|p|mb|2S!|mb|p|mb|2N!|mb|p|mb|4S|mb|p|mb|p|mb|p|pg||
pc|h2|pc|s7|pc|h9|pc|h7|pg||
pc|s9|pc|s3|pc|sK|pc|s2|pg||
pc|c3|pc|c5|pc|cK|pc|c2|pg||
pc|sT|pc|s6|pc|sQ|pc|sA|pg||
pc|cA|pc|c7|pc|c4|pc|c6|pg||
pc|c8|pc|cQ|pc|sJ|pc|cT|pg||
pc|hQ|pc|hA|pc|h3|pc|d2|pg||
pc|s8|pc|d3|pc|d7|pc|h5|pg||
pc|s5|pc|d5|pc|c9|pc|h4|pg||
pc|s4|pc|d8|pc|cJ|pc|d6|pg||
pc|hK|pc|hT|pc|d9|pc|h6|pg||
pc|dA|pc|dJ|pc|dT|pc|h8|pg||
pc|d4|pc|dK|pc|dQ|pc|hJ|pg||
pg||
qx|c11|st||md|1SKQ854HAK7DA4CT63,SA2HT32DKJ853CA85,ST97HDQT972CKQJ97,SJ63HQJ98654D6C42|sv|o|mb|1N|mb|p|mb|3H|mb|p|mb|3S|mb|p|mb|4S|mb|p|mb|p|mb|p|pg||
pc|sA|pc|s7|pc|s6|pc|s4|pg||
pc|s2|pc|s9|pc|s3|pc|sQ|pg||
pc|h7|pc|h3|pc|sT|pc|h4|pg||
pc|cK|pc|c2|pc|c3|pc|c5|pg||
pc|d2|pc|d6|pc|dA|pc|d3|pg||
pc|sK|pc|d5|pc|c7|pc|sJ|pg||
pc|c6|pc|c8|pc|cQ|pc|c4|pg||
pc|dQ|pc|h5|pc|d4|pc|dK|pg||
pc|cA|pc|c9|pc|h6|pc|cT|pg||
mc|10|pg||
qx|o12|st||md|2SA7HJ84DQT862C765,SQ54HK765DKJ53C98,SKJ96HAT92D94CQJT,ST832HQ3DA7CAK432|sv|n|mb|p|mb|1C|mb|p|mb|1D|mb|p|mb|1H|mb|p|mb|1N|mb|p|mb|p|mb|p|pg||
pc|c9|pc|cT|pc|c2|pc|c5|pg||
pc|h2|pc|h3|pc|h8|pc|hK|pg||
pc|c8|pc|cJ|pc|cK|pc|c6|pg||
pc|cA|pc|c7|pc|h5|pc|cQ|pg||
pc|c3|pc|d2|pc|h6|pc|d4|pg||
pc|c4|pc|d6|pc|h7|pc|d9|pg||
pc|dA|pc|d8|pc|d3|pc|s6|pg||
pc|d7|pc|dT|pc|dJ|pc|s9|pg||
pc|dK|pc|h9|pc|hQ|pc|dQ|pg||
pc|d5|pc|hT|pc|s2|pc|h4|pg||
mc|4|pg||
qx|c12|st||md|2SA7HJ84DQT862C765,SQ54HK765DKJ53C98,SKJ96HAT92D94CQJT,ST832HQ3DA7CAK432|sv|n|mb|p|mb|p|mb|1C|mb|p|mb|1D|mb|p|mb|1S|mb|p|mb|1N|mb|p|mb|p|mb|p|pg||
pc|cQ|pc|c2|pc|c7|pc|c9|pg||
pc|s6|pc|s2|pc|sA|pc|s4|pg||
pc|s7|pc|sQ|pc|sK|pc|s3|pg||
pc|d4|pc|d7|pc|dQ|pc|dK|pg||
pc|s5|pc|sJ|pc|s8|pc|h4|pg||
pc|d9|pc|dA|pc|d2|pc|d3|pg||
pc|sT|pc|dT|pc|h5|pc|s9|pg||
pc|cA|pc|c5|pc|c8|pc|cT|pg||
pc|cK|pc|c6|pc|h6|pc|cJ|pg||
pc|c4|pc|h8|pc|d5|pc|h2|pg||
pc|c3|pc|hJ|pc|dJ|pc|h9|pg||
pc|h3|pc|d6|pc|hK|pc|hA|pg||
pc|hT|pc|hQ|pc|d8|pc|h7|pg||
pg||
qx|o13|st||md|3SAQ8653H6DJT54CA3,SK4HAQ753D32C8752,SJT97HJ92DQ7CKQJT,S2HKT84DAK986C964|sv|b|mb|p|mb|p|mb|1S|mb|p|mb|2C!|mb|d|mb|4S|mb|p|mb|p|mb|p|pg||
pc|d3|pc|d7|pc|dK|pc|d5|pg||
pc|h4|pc|h6|pc|hQ|pc|h2|pg||
pc|d2|pc|dQ|pc|dA|pc|d4|pg||
pc|d6|pc|dT|pc|sK|pc|h9|pg||
mc|9|pg||
qx|c13|st||md|3SAQ8653H6DJT54CA3,SK4HAQ753D32C8752,SJT97HJ92DQ7CKQJT,S2HKT84DAK986C964|sv|b|mb|p|mb|p|mb|1S|mb|p|mb|2C|mb|2D|mb|4S|mb|p|mb|p|mb|p|pg||
pc|d3|pc|dQ|pc|dK|pc|d5|pg||
pc|dA|pc|dT|pc|d2|pc|d7|pg||
pc|h4|pc|h6|pc|hQ|pc|h2|pg||
pc|hA|pc|h9|pc|h8|pc|s3|pg||
pc|c3|pc|c2|pc|cT|pc|c4|pg||
pc|hJ|pc|hK|pc|s5|pc|h3|pg||
mc|9|pg||
qx|o14|st||md|4SAJ92HQ84DJ754CQ2,SQT65HT52D32CKJ93,S74HK963DQT6C8654,SK83HAJ7DAK98CAT7|sv|o|mb|1D|mb|p|mb|1S|mb|p|mb|2N|mb|p|mb|3N|mb|p|mb|p|mb|p|pg||
pc|h4|pc|h2|pc|hK|pc|hA|pg||
pc|sK|pc|sA|pc|s5|pc|s4|pg||
pc|hQ|pc|h5|pc|h3|pc|h7|pg||
pc|h8|pc|hT|pc|h6|pc|hJ|pg||
pc|s8|pc|s2|pc|sT|pc|s7|pg||
pc|d2|pc|d6|pc|d9|pc|dJ|pg||
pc|sJ|pc|sQ|pc|c6|pc|s3|pg||
pc|d3|pc|dT|pc|dA|pc|d4|pg||
pc|dK|pc|d5|pc|c3|pc|dQ|pg||
pc|d8|pc|d7|pc|s6|pc|h9|pg||
pc|c7|pc|c2|pc|cK|pc|c4|pg||
pc|cJ|pc|c5|pc|cA|pc|cQ|pg||
pc|cT|pc|s9|pc|c9|pc|c8|pg||
pg||
qx|c14|st||md|4SAJ92HQ84DJ754CQ2,SQT65HT52D32CKJ93,S74HK963DQT6C8654,SK83HAJ7DAK98CAT7|sv|o|mb|1C|mb|p|mb|1H|mb|p|mb|2D|mb|p|mb|2H|mb|p|mb|2N|mb|p|mb|3N|mb|p|mb|p|mb|p|pg||
pc|d4|pc|d2|pc|dQ|pc|dA|pg||
pc|cA|pc|c2|pc|c3|pc|c4|pg||
pc|c7|pc|cQ|pc|cK|pc|c5|pg||
pc|s5|pc|s4|pc|sK|pc|sA|pg||
pc|h4|pc|h2|pc|hK|pc|hA|pg||
pc|h7|pc|hQ|pc|h5|pc|h3|pg||
pc|h8|pc|hT|pc|h6|pc|hJ|pg||
pc|s8|pc|s9|pc|sT|pc|s7|pg||
pc|cJ|pc|c6|pc|cT|pc|d5|pg||
pc|c9|pc|c8|pc|d8|pc|d7|pg||
pc|d3|pc|d6|pc|dK|pc|dJ|pg||
pc|s3|pc|s2|pc|sQ|pc|dT|pg||
pc|s6|pc|h9|pc|d9|pc|sJ|pg||
pg||
qx|o15|st||md|1ST2H765DKT73CQ763,SJ8764HKT9D652CT2,S93HAJ43DAJ8CKJ85,SAKQ5HQ82DQ94CA94|sv|n|mb|p|mb|p|mb|1C|mb|1N|mb|p|mb|2H!|mb|p|mb|3S!|mb|p|mb|p|mb|p|pg||
pc|c6|pc|c2|pc|c8|pc|c9|pg||
pc|sA|pc|s2|pc|s4|pc|s3|pg||
pc|sK|pc|sT|pc|s6|pc|s9|pg||
pc|cA|pc|c3|pc|cT|pc|c5|pg||
pc|c4|pc|c7|pc|s7|pc|cJ|pg||
pc|d2|pc|d8|pc|dQ|pc|dK|pg||
pc|h5|pc|hT|pc|hJ|pc|hQ|pg||
mc|9|pg||
qx|c15|st||md|1ST2H765DKT73CQ763,SJ8764HKT9D652CT2,S93HAJ43DAJ8CKJ85,SAKQ5HQ82DQ94CA94|sv|n|mb|p|mb|p|mb|1C|mb|1N|mb|p|mb|2H|mb|p|mb|2S|mb|p|mb|p|mb|p|pg||
pc|c6|pc|c2|pc|cK|pc|c4|pg||
pc|dA|pc|d4|pc|d3|pc|d2|pg||
pc|d8|pc|dQ|pc|dK|pc|d5|pg||
pc|d7|pc|d6|pc|dJ|pc|d9|pg||
pc|cJ|pc|cA|pc|c3|pc|cT|pg||
pc|sA|pc|s2|pc|s4|pc|s3|pg||
pc|sK|pc|sT|pc|s6|pc|s9|pg||
pc|c9|pc|c7|pc|s7|pc|c5|pg||
pc|s8|mc|7|pg||
qx|o16|st||md|2S4HA42DT753CKT963,SAKT965HT3DA98C75,SQJ832HK976D42CA8,S7HQJ85DKQJ6CQJ42|sv|e|mb|1S|mb|p|mb|1N!|mb|p|mb|2S|mb|p|mb|2N|mb|p|mb|3N|mb|d|mb|p|mb|p|mb|p|pg||
pc|c3|pc|c5|pc|cA|pc|c2|pg||
pc|c8|pc|cQ|pc|cK|pc|c7|pg||
pc|cT|pc|s5|pc|s2|pc|cJ|pg||
pc|h5|pc|h4|pc|hT|pc|h7|pg||
pc|dA|pc|d2|pc|d6|pc|d3|pg||
pc|d8|pc|d4|pc|dJ|pc|d5|pg||
pc|dQ|pc|d7|pc|d9|pc|s3|pg||
pc|dK|pc|dT|pc|s6|pc|h6|pg||
pc|s7|pc|s4|pc|sA|pc|s8|pg||
pc|sK|pc|sJ|pc|c4|pc|h2|pg||
mc|8|pg||
qx|c16|st||md|2S4HA42DT753CKT963,SAKT965HT3DA98C75,SQJ832HK976D42CA8,S7HQJ85DKQJ6CQJ42|sv|e|mb|1S|mb|p|mb|2C|mb|p|mb|2S|mb|p|mb|3N|mb|p|mb|p|mb|p|pg||
pc|c6|pc|c7|pc|cA|pc|c2|pg||
pc|c8|pc|cJ|pc|cK|pc|c5|pg||
pc|cT|pc|s5|pc|d2|pc|cQ|pg||
pc|s7|pc|s4|pc|sA|pc|s2|pg||
pc|d8|pc|d4|pc|dK|pc|d3|pg||
pc|dQ|pc|d5|pc|d9|pc|h6|pg||
pc|d6|pc|d7|pc|dA|pc|h7|pg||
mc|8|pg||