vg|D - Venice Cup 2011,Semi Final 5_6,I,1,16,England,137,Indonesia,116|
rs|3NE=,3NW+3,3HS-1,3HS=,4HN=,4HN=,4SW+1,4SW+1,1NE+4,2SW+2,5SE=,4SE+1,4SS=,4SS=,4DN=,4SW-1,2SN+2,2HN+2,2HE+1,2HE=,4SW-2,3CN+2,2DS+1,2SE-1,1NS-1,2HN+1,6CW=,6CW=,3NS+1,6NS=,4SE=,4HE-1|
pn|DHONDY,DEWI,SENIOR,MURNIATI,TUEJE,BROCK,BOJOH,SMITH|pg||
qx|o1|st||md|3S95HJ65DA62CKQ954,SQ64HAQDKT974CJ72,SKJ873HT92D53CT83,SAT2HK8743DQJ8CA6|sv|o|mb|p|mb|3N|mb|p|mb|p|mb|p|pg||
pc|c4|mc|9|pg||
qx|c1|st||md|3S95HJ65DA62CKQ954,SQ64HAQDKT974CJ72,SKJ873HT92D53CT83,SAT2HK8743DQJ8CA6|sv|o|mb|p|mb|1H|mb|p|mb|2D|mb|p|mb|3D|mb|p|mb|3N|mb|p|mb|p|mb|p|pg||
pc|s7|pc|sT|pc|s5|pc|s4|pg||
pc|dQ|pc|d2|pc|d4|pc|d3|pg||
pc|dJ|pc|d6|pc|d7|pc|d5|pg||
pc|d8|pc|dA|pc|d9|pc|c3|pg||
pc|s9|pc|sQ|pc|sK|pc|sA|pg||
pc|h7|pc|h5|pc|hA|pc|h2|pg||
pc|dK|pc|s3|pc|s2|pc|c5|pg||
pc|dT|pc|hT|pc|c6|pc|c4|pg||
pc|hQ|pc|h9|pc|h3|pc|h6|pg||
mc|12|pg||
qx|o2|st||md|4SQT65HAQJ63DKJCK5,SJ32HKT7DAQ942C62,SA8H9842DT83CJ974,SK974H5D765CAQT83|sv|n|mb|p|mb|1H|mb|p|mb|2H|mb|d|mb|r|mb|3D|mb|3H|mb|p|mb|p|mb|p|pg||
pc|c6|pc|c7|pc|cA|pc|c5|pg||
pc|d7|pc|dJ|pc|dQ|pc|d3|pg||
pc|s2|pc|s8|pc|sK|pc|s5|pg||
pc|c3|pc|cK|pc|c2|pc|c4|pg||
pc|s6|pc|s3|pc|sA|pc|s4|pg||
pc|h2|pc|h5|pc|hQ|pc|hK|pg||
pc|dA|pc|d8|pc|d5|pc|dK|pg||
pc|d2|pc|dT|pc|d6|pc|sT|pg||
mc|8|pg||
qx|c2|st||md|4SQT65HAQJ63DKJCK5,SJ32HKT7DAQ942C62,SA8H9842DT83CJ974,SK974H5D765CAQT83|sv|n|mb|p|mb|1H|mb|p|mb|2H|mb|d|mb|r|mb|3D|mb|p|mb|p|mb|3H|mb|p|mb|p|mb|p|pg||
pc|c6|pc|c4|pc|c3|pc|cK|pg||
pc|hA|pc|h7|pc|h2|pc|h5|pg||
pc|hQ|pc|hK|pc|h4|pc|d6|pg||
pc|hT|pc|h8|pc|c8|pc|hJ|pg||
pc|s5|pc|s2|pc|sA|pc|s4|pg||
pc|s8|pc|s9|pc|sQ|pc|s3|pg||
pc|c5|pc|c2|pc|c7|pc|cT|pg||
pc|cA|pc|h3|pc|d2|pc|c9|pg||
pc|sT|pc|sJ|pc|h9|pc|s7|pg||
pc|d3|pc|d5|pc|dK|pc|dA|pg||
pc|dQ|pc|d8|pc|d7|pc|dJ|pg||
mc|9|pg||
qx|o3|st||md|1ST92HKQDT63CT8753,SQJ854H32DAJ4CJ62,SK6HAJT84D8CAKQ94,SA73H9765DKQ9752C|sv|e|mb|p|mb|p|mb|1H|mb|p|mb|p|mb|d|mb|3C|mb|3D|mb|4H|mb|p|mb|p|mb|p|pg||
pc|dK|pc|d3|pc|dA|pc|d8|pg||
pc|sQ|pc|sK|pc|sA|pc|s2|pg||
pc|s7|pc|s9|pc|sJ|pc|s6|pg||
pc|s8|pc|c4|pc|s3|pc|sT|pg||
pc|hQ|pc|h2|pc|h4|pc|h5|pg||
pc|hK|pc|h3|pc|hA|pc|h6|pg||
mc|10|pg||
qx|c3|st||md|1ST92HKQDT63CT8753,SQJ854H32DAJ4CJ62,SK6HAJT84D8CAKQ94,SA73H9765DKQ9752C|sv|e|mb|p|mb|p|mb|1H|mb|p|mb|1N|mb|p|mb|2C!|mb|2D|mb|p|mb|p|mb|d|an|strong|mb|p|mb|2H|mb|p|mb|4H|mb|p|mb|p|mb|p|pg||
pc|dK|pc|d3|pc|d4|pc|d8|pg||
pc|d5|pc|dT|pc|dA|pc|h4|pg||
pc|h8|pc|h5|pc|hQ|pc|h2|pg||
pc|hK|pc|h3|pc|hA|pc|h6|pg||
pc|hJ|pc|h7|pc|s2|pc|s4|pg||
pc|hT|pc|h9|pc|d6|pc|s5|pg||
pc|cA|pc|d2|pc|c3|pc|c2|pg||
pc|cK|pc|d7|pc|c5|pc|c6|pg||
pc|cQ|pc|s3|pc|c7|pc|cJ|pg||
pc|c4|pc|s7|pc|cT|pc|dJ|pg||
pc|c8|pc|s8|pc|c9|pc|d9|pg||
mc|10|pg||
qx|o4|st||md|2SKJ2HQ542D853CKQ7,SAQ873HK83DAQT9C6,S9HT97DJ72CAJ9432,ST654HAJ6DK64CT85|sv|b|mb|1S|mb|p|mb|2S|mb|p|mb|4S|mb|p|mb|p|mb|p|pg||
pc|hT|pc|hJ|pc|hQ|pc|hK|pg||
pc|sA|pc|s9|pc|s4|pc|s2|pg||
pc|d9|pc|d7|pc|dK|pc|d8|pg||
pc|s5|pc|sK|pc|s3|pc|c2|pg||
pc|h5|pc|h3|pc|h7|pc|hA|pg||
pc|s6|pc|sJ|pc|sQ|pc|c3|pg||
pc|dQ|pc|d2|pc|d4|pc|d3|pg||
pc|dA|pc|dJ|pc|d6|pc|d5|pg||
pc|dT|pc|c4|pc|h6|pc|c7|pg||
mc|11|pg||
qx|c4|st||md|2SKJ2HQ542D853CKQ7,SAQ873HK83DAQT9C6,S9HT97DJ72CAJ9432,ST654HAJ6DK64CT85|sv|b|mb|1S|mb|p|mb|3S|mb|p|mb|4S|mb|p|mb|p|mb|p|pg||
pc|hT|pc|hA|pc|h2|pc|h3|pg||
pc|c5|pc|c7|pc|c6|pc|c9|pg||
pc|cA|pc|c8|pc|cQ|pc|s3|pg||
pc|sA|pc|s9|pc|s4|pc|s2|pg||
pc|d9|pc|d7|pc|dK|pc|d3|pg||
pc|s5|pc|sK|pc|s7|pc|c3|pg||
pc|cK|pc|s8|pc|c2|pc|cT|pg||
pc|sQ|pc|c4|pc|s6|pc|sJ|pg||
pc|dA|pc|d2|pc|d4|pc|d5|pg||
pc|dQ|pc|dJ|pc|d6|pc|d8|pg||
pc|dT|pc|h7|pc|h6|pc|h4|pg||
pc|hK|pc|h9|pc|hJ|pc|h5|pg||
pc|h8|pc|cJ|pc|sT|pc|hQ|pg||
pg||
qx|o5|st||md|3SK5HK53DAJ876CQJ6,SA832HT96DK953CT8,ST74HQ82DT2CA7532,SQJ96HAJ74DQ4CK94|sv|n|mb|p|mb|1N|mb|p|mb|p|mb|p|pg||
pc|d7|pc|d3|pc|dT|pc|dQ|pg||
pc|sQ|pc|sK|pc|sA|pc|s4|pg||
pc|s2|pc|s7|pc|s9|pc|s5|pg||
pc|d4|pc|d6|pc|d9|pc|d2|pg||
pc|hT|pc|h2|pc|h4|pc|hK|pg||
pc|dA|pc|d5|pc|sT|pc|c4|pg||
pc|cQ|pc|c8|pc|c2|pc|cK|pg||
pc|sJ|pc|h3|pc|s3|pc|c3|pg||
pc|s6|pc|d8|pc|s8|pc|c5|pg||
pc|dK|pc|c7|pc|c9|pc|dJ|pg||
pc|h9|pc|h8|pc|h7|pc|h5|pg||
pc|h6|pc|hQ|pc|hA|pc|c6|pg||
pc|hJ|pc|cJ|pc|cT|pc|cA|pg||
pg||
qx|c5|st||md|3SK5HK53DAJ876CQJ6,SA832HT96DK953CT8,ST74HQ82DT2CA7532,SQJ96HAJ74DQ4CK94|sv|n|mb|p|mb|1C!|mb|1D|mb|1S|mb|p|mb|2S|mb|p|mb|p|mb|p|pg||
pc|dT|pc|dQ|pc|dA|pc|d3|pg||
pc|d6|pc|d9|pc|d2|pc|d4|pg||
pc|hT|pc|hQ|pc|hA|pc|h3|pg||
pc|sQ|pc|s5|pc|s3|pc|s4|pg||
pc|s6|pc|sK|pc|sA|pc|s7|pg||
pc|s2|pc|sT|pc|sJ|pc|d7|pg||
pc|h4|pc|hK|pc|h6|pc|h2|pg||
pc|cJ|pc|c8|pc|cA|pc|c4|pg||
pc|c2|pc|cK|pc|c6|pc|cT|pg||
pc|h7|pc|h5|pc|h9|pc|h8|pg||
mc|10|pg||
qx|o6|st||md|4SQH7DAKT986CKT642,SKJT93HJ9653D32CA,S74HKT842DQJ7CQJ7,SA8652HAQD54C9853|sv|e|mb|p|mb|1D|mb|2D!|mb|d|mb|4S|mb|5C|mb|p|mb|5D|mb|5S|mb|p|mb|p|mb|p|pg||
pc|dK|pc|d2|pc|dQ|pc|d4|pg||
pc|h7|pc|h3|pc|h4|pc|hQ|pg||
pc|s2|pc|sQ|pc|sK|pc|s4|pg||
pc|s3|pc|s7|pc|s8|pc|d8|pg||
pc|hA|pc|c2|pc|h5|pc|h2|pg||
mc|11|pg||
qx|c6|st||md|4SQH7DAKT986CKT642,SKJT93HJ9653D32CA,S74HKT842DQJ7CQJ7,SA8652HAQD54C9853|sv|e|mb|p|mb|1D|mb|2D!|mb|d|mb|4S|mb|p|mb|p|mb|p|pg||
pc|dA|pc|d2|pc|dQ|pc|d4|pg||
pc|h7|pc|h3|pc|h2|pc|hQ|pg||
pc|s2|pc|sQ|pc|sK|pc|s4|pg||
pc|sJ|pc|s7|pc|s5|pc|d6|pg||
pc|h5|pc|h4|pc|hA|pc|d8|pg||
pc|c5|pc|c4|pc|cA|pc|c7|pg||
pc|h6|pc|h8|pc|s6|pc|c2|pg||
mc|11|pg||
qx|o7|st||md|1SKQJ953HADQ5CA973,ST742H973DAJ72CK5,SA8HKJ65DK9863CT8,S6HQT842DT4CQJ642|sv|b|mb|1S|mb|p|mb|2D|mb|p|mb|2S|mb|p|mb|3H|mb|p|mb|3S|mb|p|mb|4S|mb|p|mb|p|mb|p|pg||
pc|h3|pc|h5|pc|hT|pc|hA|pg||
pc|c3|pc|cK|pc|c8|pc|c6|pg||
pc|s2|pc|s8|pc|s6|pc|s3|pg||
pc|cT|pc|cJ|pc|cA|pc|c5|pg||
pc|c7|pc|h7|pc|sA|pc|c2|pg||
pc|hK|pc|h2|pc|c9|pc|h9|pg||
pc|h6|pc|h8|pc|sJ|pc|d2|pg||
pc|sK|pc|s4|pc|d3|pc|c4|pg||
pc|sQ|pc|s7|pc|d6|pc|h4|pg||
pc|dQ|pc|dA|pc|d8|pc|d4|pg||
mc|10|pg||
qx|c7|st||md|1SKQJ953HADQ5CA973,ST742H973DAJ72CK5,SA8HKJ65DK9863CT8,S6HQT842DT4CQJ642|sv|b|mb|1S|mb|p|mb|1N|mb|p|mb|3S|mb|p|mb|4S|mb|p|mb|p|mb|p|pg||
pc|h7|pc|h5|pc|hT|pc|hA|pg||
pc|c3|pc|cK|pc|c8|pc|c2|pg||
pc|h9|pc|hK|pc|h4|pc|c7|pg||
pc|sA|pc|s6|pc|s3|pc|s2|pg||
pc|cT|pc|c4|pc|cA|pc|c5|pg||
pc|c9|pc|sT|pc|d3|pc|c6|pg||
pc|s4|pc|s8|pc|cJ|pc|sK|pg||
pc|sQ|pc|s7|pc|d6|pc|h2|pg||
pc|sJ|pc|d2|pc|h6|pc|cQ|pg||
mc|10|pg||
qx|o8|st||md|2SA874HQ8765DQ92C8,SKT95HJ92D53CQT63,SJ2HTDAKT8764C952,SQ63HAK43DJCAKJ74|sv|o|mb|p|mb|3D|mb|d|mb|4D|mb|p|mb|p|mb|p|pg||
pc|cA|pc|c8|pc|cT|pc|c2|pg||
pc|dJ|pc|d2|pc|d3|pc|dA|pg||
pc|hT|pc|hK|pc|h5|pc|h2|pg||
pc|s3|pc|sA|pc|s5|pc|s2|pg||
pc|h6|pc|h9|pc|d4|pc|h3|pg||
pc|c5|pc|c4|pc|d9|pc|c3|pg||
pc|h7|pc|hJ|pc|d6|pc|h4|pg||
pc|c9|pc|c7|pc|dQ|pc|c6|pg||
pc|h8|pc|s9|pc|d7|pc|hA|pg||
pc|dK|pc|cJ|pc|s4|pc|d5|pg||
pc|dT|pc|s6|pc|s7|pc|sT|pg||
pc|d8|pc|sQ|pc|s8|pc|cQ|pg||
pc|sJ|pc|cK|pc|hQ|pc|sK|pg||
pg||
qx|c8|st||md|2SA874HQ8765DQ92C8,SKT95HJ92D53CQT63,SJ2HTDAKT8764C952,SQ63HAK43DJCAKJ74|sv|o|mb|p|mb|3D|mb|d|mb|p|mb|3S|mb|p|mb|4S|mb|p|mb|p|mb|p|pg||
pc|dA|pc|dJ|pc|d2|pc|d5|pg||
pc|hT|pc|hA|pc|h5|pc|h2|pg||
pc|c4|pc|c8|pc|cQ|pc|c2|pg||
pc|d3|pc|dK|pc|s3|pc|d9|pg||
pc|sQ|pc|sA|pc|s5|pc|s2|pg||
pc|h6|pc|hJ|pc|sJ|pc|h3|pg||
pc|d4|pc|s6|pc|dQ|pc|c3|pg||
pc|c7|pc|s7|pc|c6|pc|c5|pg||
pc|hQ|pc|h9|pc|d6|mc|9|pg||
qx|o9|st||md|3ST7642HK9DA52C854,SQ8HT63DK764CAJ92,SAK9HQJ754DQJ9CK3,SJ53HA82DT83CQT76|sv|e|mb|1N|mb|p|mb|2H!|mb|p|mb|2S|mb|p|mb|p|mb|p|pg||
pc|d3|pc|d2|pc|dK|pc|d9|pg||
pc|c9|pc|cK|pc|c6|pc|c4|pg||
pc|h4|pc|h2|pc|hK|pc|h6|pg||
pc|h9|pc|h3|pc|hQ|pc|hA|pg||
pc|d8|pc|d5|pc|d4|pc|dJ|pg||
pc|sA|pc|s3|pc|s2|pc|s8|pg||
pc|sK|pc|s5|pc|s4|pc|sQ|pg||
pc|hJ|pc|h8|pc|c5|pc|hT|pg||
pc|h7|mc|10|pg||
qx|c9|st||md|3ST7642HK9DA52C854,SQ8HT63DK764CAJ92,SAK9HQJ754DQJ9CK3,SJ53HA82DT83CQT76|sv|e|mb|1H|mb|p|mb|1S|mb|p|mb|1N!|mb|p|mb|2H|mb|p|mb|p|mb|p|pg||
pc|h2|pc|h9|pc|hT|pc|hQ|pg||
pc|h4|pc|hA|pc|hK|pc|h3|pg||
pc|h8|pc|c4|pc|h6|pc|hJ|pg||
pc|sA|pc|s3|pc|s2|pc|s8|pg||
pc|sK|pc|s5|pc|s4|pc|sQ|pg||
pc|s9|pc|sJ|pc|s6|pc|c2|pg||
pc|d3|pc|dA|pc|d4|pc|d9|pg||
pc|sT|pc|c9|pc|c3|pc|d8|pg||
pc|s7|pc|d6|pc|cK|pc|c6|pg||
pc|d5|pc|dK|pc|dJ|pc|dT|pg||
mc|10|pg||
qx|o10|st||md|4SJ98HQ95DJT9CAK63,SA64HKJT8DAQ73C42,SQ52H32DK652CJ985,SKT73HA764D84CQT7|sv|b|mb|p|mb|p|mb|1D!|mb|p|mb|1H|mb|p|mb|2H|mb|p|mb|p|mb|p|pg||
pc|cK|pc|c2|pc|c5|pc|c7|pg||
pc|s8|pc|s4|pc|sQ|pc|sK|pg||
pc|d8|pc|dJ|pc|dQ|pc|dK|pg||
pc|s5|pc|s3|pc|s9|pc|sA|pg||
pc|hJ|pc|h2|pc|h4|pc|hQ|pg||
pc|sJ|pc|s6|pc|s2|pc|s7|pg||
pc|dT|pc|dA|pc|d2|pc|d4|pg||
pc|hK|pc|h3|pc|h6|pc|h5|pg||
pc|h8|pc|c8|pc|hA|pc|h9|pg||
pc|sT|pc|c3|pc|c4|pc|c9|pg||
pc|cQ|pc|cA|pc|hT|pc|cJ|pg||
mc|9|pg||
qx|c10|st||md|4SJ98HQ95DJT9CAK63,SA64HKJT8DAQ73C42,SQ52H32DK652CJ985,SKT73HA764D84CQT7|sv|b|mb|p|mb|p|mb|1C|mb|p|mb|1H|mb|p|mb|2H|mb|p|mb|p|mb|p|pg||
pc|dJ|pc|dQ|pc|dK|pc|d4|pg||
pc|s2|pc|s3|pc|s8|pc|sA|pg||
pc|c2|pc|c8|pc|c7|pc|cK|pg||
pc|sJ|pc|s4|pc|s5|pc|sK|pg||
pc|d8|pc|d9|pc|dA|pc|d2|pg||
pc|c4|pc|c9|pc|cQ|pc|cA|pg||
pc|s9|pc|s6|pc|sQ|pc|s7|pg||
pc|cJ|pc|cT|pc|c3|pc|h8|pg||
pc|d3|pc|d5|pc|h4|pc|dT|pg||
pc|sT|pc|h5|pc|hT|pc|d6|pg||
pc|d7|pc|h3|pc|h6|pc|h9|pg||
pc|c6|mc|8|pg||
qx|o11|st||md|1S872HAQ85D5CKJ983,SAQ964H9DQJ842C42,S3H743DAKT76CAQ76,SKJT5HKJT62D93CT5|sv|o|mb|p|mb|p|mb|1D|mb|2D!|mb|d|mb|4S|mb|p|mb|p|mb|p|pg||
pc|dK|pc|d3|pc|d5|pc|d4|pg||
pc|dA|pc|d9|pc|c9|pc|d2|pg||
pc|d6|pc|sK|pc|c3|pc|d8|pg||
pc|s5|pc|s2|pc|s9|pc|s3|pg||
pc|sA|pc|c6|pc|sT|pc|s7|pg||
pc|h9|pc|h7|pc|hK|pc|hA|pg||
pc|cJ|pc|c2|pc|c7|pc|c5|pg||
pc|c8|pc|c4|pc|cQ|pc|cT|pg||
pc|d7|pc|sJ|pc|h5|pc|dJ|pg||
pc|h2|pc|h8|pc|s4|pc|h3|pg||
pc|sQ|mc|8|pg||
qx|c11|st||md|1S872HAQ85D5CKJ983,SAQ964H9DQJ842C42,S3H743DAKT76CAQ76,SKJT5HKJT62D93CT5|sv|o|mb|p|mb|p|mb|1D|mb|1H|mb|1N|mb|p|mb|2C|an|can be 5!C 4!D|mb|p|mb|2H|mb|2S|mb|p|mb|p|mb|3C|mb|p|mb|p|mb|p|pg||
pc|sJ|pc|s2|pc|sA|pc|s3|pg||
pc|c2|pc|c7|pc|cT|pc|cJ|pg||
pc|s7|pc|s4|pc|c6|pc|s5|pg||
pc|dA|pc|d3|pc|d5|pc|d2|pg||
pc|dK|pc|d9|pc|h5|pc|d4|pg||
pc|d6|pc|h2|pc|c3|pc|d8|pg||
pc|s8|pc|s6|pc|cA|pc|sT|pg||
pc|h4|pc|h6|pc|hQ|pc|h9|pg||
pc|cK|pc|c4|pc|cQ|pc|c5|pg||
mc|11|pg||
qx|o12|st||md|2S96HAKDAKJ32CQJ85,SAKJ7HQT2DQT54CT2,ST4H9754D76CAK643,SQ8532HJ863D98C97|sv|n|mb|1N|mb|p|mb|2C!|mb|2D|mb|p|mb|p|mb|p|pg||
pc|sA|pc|s4|pc|s5|pc|s6|pg||
pc|cT|pc|c3|pc|c7|pc|cQ|pg||
pc|dA|pc|d4|pc|d6|pc|d8|pg||
pc|dK|pc|d5|pc|d7|pc|d9|pg||
pc|d2|pc|dT|pc|h4|pc|h8|pg||
pc|sK|pc|sT|pc|s2|pc|s9|pg||
mc|9|pg||
qx|c12|st||md|2S96HAKDAKJ32CQJ85,SAKJ7HQT2DQT54CT2,ST4H9754D76CAK643,SQ8532HJ863D98C97|sv|n|mb|1C|mb|p|mb|1S|mb|2D|mb|2S|mb|p|mb|p|mb|p|pg||
pc|dA|pc|d4|pc|d6|pc|d8|pg||
pc|s6|pc|sA|pc|s4|pc|s2|pg||
pc|sK|pc|sT|pc|s3|pc|s9|pg||
pc|hT|pc|h4|pc|h3|pc|hA|pg||
pc|cQ|pc|c2|pc|c3|pc|c7|pg||
pc|c5|pc|cT|pc|cA|pc|c9|pg||
pc|d7|pc|d9|pc|dK|pc|d5|pg||
pc|hK|pc|h2|pc|h5|pc|h6|pg||
mc|7|pg||
qx|o13|st||md|3S7542HQ94DAJ6CAJ8,SKQ63H852DQ7CKT52,STHAT73DKT84CQ964,SAJ98HKJ6D9532C73|sv|b|mb|p|mb|p|mb|1C!|mb|p|mb|1H|mb|p|mb|1N|mb|p|mb|p|mb|p|pg||
pc|s3|pc|sT|pc|sA|pc|s4|pg||
pc|s8|pc|s5|pc|sQ|pc|h3|pg||
pc|sK|pc|c4|pc|s9|pc|s2|pg||
pc|s6|pc|h7|pc|sJ|pc|s7|pg||
pc|c7|pc|c8|pc|cK|pc|c6|pg||
pc|c2|pc|cQ|pc|c3|pc|cJ|pg||
pc|d4|pc|d2|pc|dJ|pc|dQ|pg||
pc|c5|pc|c9|pc|h6|pc|cA|pg||
pc|dA|pc|d7|pc|d8|pc|d3|pg||
pc|d6|pc|h2|pc|dK|pc|d5|pg||
pc|dT|pc|d9|pc|h4|pc|cT|pg||
pc|hA|pc|hJ|pc|h9|pc|h5|pg||
pc|hT|pc|hK|pc|hQ|pc|h8|pg||
pg||
qx|c13|st||md|3S7542HQ94DAJ6CAJ8,SKQ63H852DQ7CKT52,STHAT73DKT84CQ964,SAJ98HKJ6D9532C73|sv|b|mb|p|mb|p|mb|1D|mb|p|mb|1H|mb|p|mb|p|mb|d|mb|r|mb|1S|mb|p|mb|p|mb|2D|mb|p|mb|2H|mb|p|mb|p|mb|p|pg||
pc|c7|pc|c8|pc|cT|pc|cQ|pg||
pc|sT|pc|sJ|pc|s2|pc|s3|pg||
pc|c3|pc|cA|pc|c2|pc|c4|pg||
pc|s4|pc|s6|pc|h3|pc|s8|pg||
pc|d4|pc|d2|pc|dA|pc|d7|pg||
pc|s5|pc|sK|pc|h7|pc|s9|pg||
pc|dK|pc|d3|pc|d6|pc|dQ|pg||
pc|c6|pc|sA|pc|cJ|pc|cK|pg||
pc|sQ|pc|hA|pc|d5|pc|s7|pg||
pc|c9|pc|hK|pc|dJ|pc|c5|pg||
pc|d9|pc|h9|pc|h2|pc|d8|pg||
pc|hQ|pc|h5|pc|hT|pc|h6|pg||
pc|h4|pc|h8|pc|dT|pc|hJ|pg||
pg||
qx|o14|st||md|4SQT982HK43DJ43CJ2,SAHAQ92DAK2CQ7543,SKJ7543HJ8DT86C86,S6HT765DQ975CAKT9|sv|o|mb|p|mb|p|mb|1C!|mb|2S|mb|d|mb|4S|mb|4N|mb|p|mb|6C|mb|p|mb|p|mb|p|pg||
pc|s5|pc|s6|pc|sQ|pc|sA|pg||
pc|c3|pc|c6|pc|cA|pc|c2|pg||
pc|c9|pc|cJ|pc|cQ|pc|c8|pg||
pc|hA|pc|h8|pc|h5|pc|h3|pg||
pc|dA|pc|d6|pc|d5|pc|d3|pg||
pc|dK|pc|d8|pc|d7|pc|d4|pg||
pc|d2|pc|dT|pc|dQ|pc|dJ|pg||
pc|d9|pc|s2|pc|h2|pc|s7|pg||
pc|h6|pc|h4|pc|h9|pc|hJ|pg||
pc|sK|pc|cT|pc|s8|pc|hQ|pg||
mc|12|pg||
qx|c14|st||md|4SQT982HK43DJ43CJ2,SAHAQ92DAK2CQ7543,SKJ7543HJ8DT86C86,S6HT765DQ975CAKT9|sv|o|mb|p|mb|p|mb|1C|an|weak NT or nat|mb|2S|mb|d|mb|4S|mb|4N!|mb|p|mb|5C|mb|p|mb|5H|mb|p|mb|6C|mb|p|mb|p|mb|p|pg||
pc|s3|pc|s6|pc|sQ|pc|sA|pg||
pc|c3|pc|c6|pc|cA|pc|c2|pg||
pc|c9|pc|cJ|pc|cQ|pc|c8|pg||
pc|dA|pc|d6|pc|d5|pc|d3|pg||
pc|dK|pc|d8|pc|d7|pc|d4|pg||
pc|d2|pc|dT|pc|dQ|pc|dJ|pg||
pc|d9|pc|s2|pc|h2|pc|s4|pg||
pc|h5|pc|h3|pc|h9|pc|hJ|pg||
pc|h8|pc|h6|pc|hK|pc|hA|pg||
mc|12|pg||
qx|o15|st||md|1SAK82HAJD73CAKQ65,S4HT8642DT86CT842,ST73HQ753DAKJ4C97,SQJ965HK9DQ952CJ3|sv|n|mb|2N|mb|p|mb|3C!|an|puppet stayman|mb|p|mb|3D!|an|1 or 2 4+ M|mb|p|mb|3S!|an|!h|mb|p|mb|3N|mb|p|mb|p|mb|p|pg||
pc|s4|pc|s3|pc|s9|pc|sK|pg||
pc|hA|pc|h2|pc|h3|pc|h9|pg||
pc|hJ|pc|h4|pc|h5|pc|hK|pg||
pc|sQ|pc|sA|pc|h6|pc|s7|pg||
pc|s2|pc|d8|pc|sT|pc|sJ|pg||
pc|s6|pc|s8|pc|d6|pc|d4|pg||
pc|d3|pc|dT|pc|dA|pc|d2|pg||
pc|hQ|pc|d5|pc|c5|pc|hT|pg||
pc|c7|pc|c3|pc|cA|pc|c2|pg||
pc|cK|pc|c4|pc|c9|pc|cJ|pg||
pc|cQ|pc|c8|pc|h7|pc|s5|pg||
pc|d7|pc|cT|pc|dK|pc|d9|pg||
pc|dJ|pc|dQ|pc|c6|pc|h8|pg||
pg||
qx|c15|st||md|1SAK82HAJD73CAKQ65,S4HT8642DT86CT842,ST73HQ753DAKJ4C97,SQJ965HK9DQ952CJ3|sv|n|mb|2C|an|strong|mb|p|mb|2S|an|3 or more controls|mb|d|mb|3C|mb|p|mb|3D|mb|p|mb|3N|mb|p|mb|6N|mb|p|mb|p|mb|p|pg||
pc|s4|pc|s7|pc|s9|pc|sA|pg||
pc|cA|pc|c2|pc|c7|pc|c3|pg||
pc|cK|pc|c4|pc|c9|pc|cJ|pg||
pc|cQ|pc|c8|pc|h3|pc|s5|pg||
pc|c6|pc|cT|pc|d4|pc|s6|pg||
pc|d6|pc|dA|pc|d2|pc|d3|pg||
pc|h5|pc|h9|pc|hJ|pc|h2|pg||
pc|c5|pc|h6|pc|s3|pc|d5|pg||
pc|hA|pc|h4|pc|h7|pc|hK|pg||
pc|d7|pc|d8|pc|dK|pc|d9|pg||
pc|hQ|pc|sJ|pc|s2|pc|h8|pg||
pc|sT|pc|sQ|mc|12|pg||
qx|o16|st||md|2SQ92HAT5DQT43CA95,S754HQ97432D8CK64,ST6HJ8DJ976CQT872,SAKJ83HK6DAK52CJ3|sv|e|mb|p|mb|p|mb|1C|an| |mb|p|mb|1D!|mb|p|mb|1S|mb|p|mb|1N|mb|p|mb|2D|mb|p|mb|2S|mb|p|mb|2N!|mb|p|mb|3H|mb|p|mb|3S|mb|p|mb|4S|mb|p|mb|p|mb|p|pg||
pc|cA|pc|c4|pc|c2|pc|c3|pg||
pc|c9|pc|cK|pc|c7|pc|cJ|pg||
pc|h2|pc|h8|pc|hK|pc|hA|pg||
pc|c5|pc|c6|pc|cQ|pc|s3|pg||
pc|dA|pc|d3|pc|d8|pc|d6|pg||
pc|d2|pc|d4|pc|s4|pc|d7|pg||
pc|hQ|pc|hJ|pc|h6|pc|h5|pg||
pc|s5|pc|s6|pc|sK|pc|s2|pg||
pc|d5|pc|dT|pc|s7|pc|d9|pg||
pc|h3|pc|sT|pc|sJ|pc|hT|pg||
pc|sA|pc|s9|pc|h4|pc|dJ|pg||
pc|dK|pc|dQ|pc|h7|pc|c8|pg||
pc|s8|pc|sQ|pc|h9|pc|cT|pg||
pg||
qx|c16|st||md|2SQ92HAT5DQT43CA95,S754HQ97432D8CK64,ST6HJ8DJ976CQT872,SAKJ83HK6DAK52CJ3|sv|e|mb|2D|an|multi|mb|p|mb|2N|an|asking|mb|p|mb|3D!|an|!H|mb|p|mb|4H|mb|p|mb|p|mb|p|pg||
pc|d4|pc|d8|pc|dJ|pc|dA|pg||
pc|d2|pc|d3|pc|h2|pc|d6|pg||
pc|h3|pc|h8|pc|hK|pc|hA|pg||
pc|h5|pc|hQ|pc|hJ|pc|h6|pg||
pc|s4|pc|s6|pc|sA|pc|s2|pg||
pc|dK|pc|dT|pc|c4|pc|d7|pg||
pc|d5|pc|dQ|pc|h4|pc|d9|pg||
pc|s5|pc|sT|pc|sJ|pc|sQ|pg||
pc|cA|pc|c6|pc|c2|pc|c3|pg||
mc|9|pg||