vg|1st World Youth Congress,RR4-B,I,1,10,Noname,0,Ckis Skawia,0|
rs|5DNxx-2,4SN-3,4HS=,3HS=,4HW-2,4SNx-1,2SN=,2SN=,6CN-1,3NS-3,4SS=,3NN-2,4HS=,4HS+1,2SW+1,2SW+3,3NN+1,3NS=,3NW=,3NW=|
pn|Ozer C.,Kania M.,Serdar E.,Witkowski ,A.Janeczko,L.Imamoglu,A.Szcyzypc,S.Sofu|pg||
qx|c3|st||md|1SQJ7HTDT7632CAJT2,S63HJ97643DAK4C64,SKT9852HK82DQ9CQ3,SA4HAQ5DJ85CK9875|sv|e|mb|p|mb|p|mb|1S|mb|d|mb|1N|mb|4H|mb|p|mb|p|mb|4S|mb|d|mb|p|mb|p|mb|p|pg||
pc|hA|pc|hT|pc|h9|pc|h2|pg||
pc|d8|pc|d2|pc|dK|pc|d9|pg||
pc|dA|pc|dQ|pc|d5|pc|d3|pg||
pc|h4|pc|h8|pc|hQ|pc|s7|pg||
pc|d6|pc|d4|pc|s8|pc|dJ|pg||
pc|s2|pc|sA|pc|sJ|pc|s3|pg||
pc|h5|pc|c2|pc|h6|pc|hK|pg||
pc|sK|pc|s4|pc|sQ|pc|s6|pg||
pc|sT|pc|c5|pc|cT|pc|h3|pg||
pc|c3|pc|c7|mc|9|pg||
qx|o4|st||md|2STHA542DKQ853CJ63,S642HJ63DCAKT9854,SAQJ953HQ8DAT64C7,SK87HKT97DJ972CQ2|sv|b|mb|p|mb|1S|mb|p|mb|1N|mb|2C|mb|2S|mb|p|mb|p|mb|p|pg||
pc|cQ|pc|c3|pc|cT|pc|c7|pg||
pc|d2|pc|dK|pc|s2|pc|d6|pg||
pc|cK|pc|s3|pc|c2|pc|c6|pg||
pc|sA|pc|s7|pc|sT|pc|s4|pg||
pc|sQ|pc|sK|pc|h2|pc|s6|pg||
pc|h7|pc|hA|pc|h3|pc|h8|pg||
pc|cJ|pc|cA|pc|s9|pc|h9|pg||
pc|sJ|pc|s8|pc|h4|pc|c4|pg||
pc|dA|pc|d7|pc|d3|pc|c5|pg||
pc|dT|pc|dJ|pc|dQ|pc|c9|pg||
pc|d8|pc|c8|pc|d4|pc|d9|pg||
pc|hK|pc|h5|pc|h6|pc|hQ|pg||
pc|hT|pc|d5|pc|hJ|pc|s5|pg||
pg||
qx|c4|st||md|2STHA542DKQ853CJ63,S642HJ63DCAKT9854,SAQJ953HQ8DAT64C7,SK87HKT97DJ972CQ2|sv|b|mb|p|mb|1S|mb|p|mb|1N!|mb|2C|mb|2S|mb|p|mb|p|mb|p|pg||
pc|cQ|pc|c3|pc|c4|pc|c7|pg||
pc|c2|pc|c6|pc|c8|pc|s3|pg||
pc|sA|pc|s7|pc|sT|pc|s4|pg||
pc|sJ|pc|sK|pc|h2|pc|s2|pg||
pc|h7|pc|hA|pc|h6|pc|h8|pg||
pc|cJ|pc|cK|pc|s5|pc|s8|pg||
pc|hK|pc|h4|pc|h3|pc|hQ|pg||
pc|hT|pc|h5|pc|hJ|pc|s9|pg||
pc|sQ|pc|h9|pc|d3|pc|s6|pg||
pc|d4|pc|d2|pc|dK|pc|c5|pg||
pc|d5|pc|c9|pc|dA|pc|d7|pg||
pc|d6|pc|d9|pc|dQ|pc|cT|pg||
pc|d8|pc|cA|pc|dT|pc|dJ|pg||
pg||
qx|o5|st||md|3SAK74H32DQ97652CQ,SQJ3HJ8DAT8CJT854,S82HAK7D4CAK97632,ST965HQT9654DKJ3C|sv|n|mb|1C|mb|2D|an|6-11 preemptive in a major|mb|d|mb|r!|mb|p|mb|2H|mb|2S|mb|p|mb|3H|mb|p|mb|4D|mb|p|mb|6C|mb|p|mb|p|mb|p|pg||
pc|hT|pc|h2|pc|hJ|pc|hA|pg||
pc|d4|pc|dK|pc|d2|pc|d8|pg||
pc|hQ|pc|h3|pc|h8|pc|hK|pg||
pc|c2|pc|h4|pc|cQ|pc|c4|pg||
pc|d5|pc|dA|pc|c3|pc|d3|pg||
pc|cA|pc|h5|pc|d6|pc|c5|pg||
pc|s2|pc|s5|pc|sA|pc|s3|pg||
pc|dQ|pc|dT|pc|h7|pc|dJ|pg||
pc|d7|pc|sJ|pc|c6|pc|h6|pg||
pc|s8|pc|s6|pc|sK|pc|sQ|pg||
pc|d9|pc|cJ|pc|c7|pc|h9|pg||
mc|11|pg||
qx|c5|st||md|3SAK74H32DQ97652CQ,SQJ3HJ8DAT8CJT854,S82HAK7D4CAK97632,ST965HQT9654DKJ3C|sv|n|mb|1C!|mb|2H|mb|2N!|mb|p|mb|3C|mb|p|mb|3S|mb|p|mb|3N|mb|p|mb|p|mb|p|pg||
pc|hJ|pc|hA|pc|h4|pc|h2|pg||
pc|c2|pc|h5|pc|cQ|pc|c4|pg||
pc|d9|pc|dT|pc|d4|pc|d3|pg||
pc|h8|pc|h7|pc|hQ|pc|h3|pg||
pc|h6|pc|s4|pc|d8|pc|hK|pg||
pc|cA|pc|s6|pc|d2|pc|c5|pg||
pc|s2|pc|s5|pc|sK|pc|s3|pg||
pc|d5|pc|dA|pc|c3|pc|dJ|pg||
pc|sQ|pc|s8|pc|s9|pc|sA|pg||
pc|d6|pc|c8|pc|c6|pc|dK|pg||
pc|hT|pc|d7|pc|cT|pc|c7|pg||
pc|h9|pc|s7|pc|cJ|pc|c9|pg||
pc|sT|pc|dQ|pc|sJ|pc|cK|pg||
pg||
qx|o6|st||md|4SAQ87HQJDQ8CT7432,SJ93HT84DAT743CQ9,ST54HAK953DKJCKJ8,SK62H762D9652CA65|sv|e|mb|p|mb|p|mb|p|mb|1H|mb|p|mb|1S|mb|p|mb|2S|mb|p|mb|4S|mb|p|mb|p|mb|p|pg||
pc|cQ|pc|cK|pc|cA|pc|c7|pg||
pc|c6|pc|c2|pc|c9|pc|cJ|pg||
pc|s4|pc|s2|pc|sQ|pc|s3|pg||
pc|sA|pc|s9|pc|s5|pc|s6|pg||
pc|s7|pc|sJ|pc|sT|pc|sK|pg||
pc|c5|pc|c3|mc|10|pg||
qx|o7|st||md|1SAT3HAJT853DJCJ43,S754H62DQ972CAK86,S982HKQ974DAT84C7,SKQJ6HDK653CQT952|sv|b|mb|1H|mb|p|mb|4C|mb|p|mb|4D|mb|p|mb|4H|mb|p|mb|p|mb|p|pg||
pc|cA|pc|c7|pc|c2|pc|c3|pg||
mc|10|pg||
qx|o8|st||md|2SKJHQ86DQ842CAJ53,SA98632HJ32DAJC82,SQ4HK95DT97CQT764,ST75HAT74DK653CK9|sv|o|mb|2D|an|6-11 weak in a major|mb|p|mb|2H|mb|d|mb|2S|mb|p|mb|p|mb|p|pg||
pc|c4|pc|c9|pc|cJ|pc|c2|pg||
pc|sJ|pc|sA|pc|s4|pc|s5|pg||
pc|c8|pc|c7|pc|cK|pc|cA|pg||
pc|sK|pc|s3|pc|sQ|pc|s7|pg||
pc|d4|pc|dJ|pc|dT|pc|d3|pg||
pc|dA|pc|d7|pc|d5|pc|d2|pg||
pc|h2|pc|h5|pc|hA|pc|h6|pg||
pc|dK|pc|d8|pc|hJ|pc|d9|pg||
pc|d6|pc|dQ|pc|h3|pc|h9|pg||
mc|9|pg||
qx|c8|st||md|2SKJHQ86DQ842CAJ53,SA98632HJ32DAJC82,SQ4HK95DT97CQT764,ST75HAT74DK653CK9|sv|o|mb|p|mb|p|mb|p|mb|1C!|mb|1S|mb|p|mb|2S|mb|p|mb|p|mb|p|pg||
pc|d9|pc|d3|pc|dQ|pc|dA|pg||
pc|sA|pc|s4|pc|s5|pc|sJ|pg||
pc|dJ|pc|d7|pc|d5|pc|d2|pg||
pc|s2|pc|sQ|pc|sT|pc|sK|pg||
pc|h8|pc|h2|pc|hK|pc|hA|pg||
pc|dK|pc|d4|pc|c2|pc|dT|pg||
pc|h4|pc|hQ|pc|h3|pc|h5|pg||
pc|h6|pc|hJ|pc|h9|pc|h7|pg||
pc|s3|pc|c4|pc|s7|pc|c3|pg||
pc|hT|pc|c5|pc|c8|pc|c6|pg||
mc|11|pg||
qx|o9|st||md|3SATHAT2DJ95CA9832,SQ9764HJ75DAK84C6,SK82HQ86DQT6CKQT4,SJ53HK943D732CJ75|sv|e|mb|1N!|an|12-14|mb|p|mb|3N|mb|p|mb|p|mb|p|pg||
pc|h3|pc|h2|pc|h5|pc|h6|pg||
pc|cK|pc|c7|pc|c2|pc|c6|pg||
pc|cQ|pc|c5|pc|c3|pc|s4|pg||
pc|cT|pc|cJ|pc|cA|pc|s7|pg||
pc|c8|pc|d4|pc|c4|pc|s5|pg||
pc|c9|pc|d8|pc|d6|pc|d7|pg||
pc|d5|pc|dA|pc|dT|pc|d3|pg||
pc|s6|pc|s2|pc|sJ|pc|sA|pg||
pc|d9|pc|dK|pc|dQ|pc|d2|pg||
pc|sQ|pc|sK|pc|s3|pc|sT|pg||
pc|s8|pc|h4|pc|hT|pc|s9|pg||
pc|h7|pc|h8|pc|h9|pc|hA|pg||
pc|dJ|pc|hJ|pc|hQ|pc|hK|pg||
pg||
qx|c9|st||md|3SATHAT2DJ95CA9832,SQ9764HJ75DAK84C6,SK82HQ86DQT6CKQT4,SJ53HK943D732CJ75|sv|e|mb|1C!|mb|p|mb|3N|mb|p|mb|p|mb|p|pg||
pc|dA|pc|d6|pc|d7|pc|d5|pg||
pc|d4|pc|dT|pc|d2|pc|d9|pg||
pc|cK|pc|c5|pc|c2|pc|c6|pg||
pc|cQ|pc|c7|pc|c3|pc|s4|pg||
pc|cT|pc|cJ|pc|cA|pc|s6|pg||
pc|c9|pc|h5|pc|c4|pc|h3|pg||
pc|c8|pc|h7|pc|dQ|pc|d3|pg||
pc|sA|pc|s7|pc|s2|pc|s5|pg||
pc|sT|pc|s9|pc|sK|pc|s3|pg||
pc|h6|pc|h4|pc|hA|pc|hJ|pg||
pc|dJ|pc|dK|pc|s8|pc|h9|pg||
pc|sQ|pc|h8|pc|sJ|pc|h2|pg||
pc|d8|pc|hQ|pc|hK|pc|hT|pg||
pg||
qx|o10|st||md|4SJ74HAK5DK532C842,SAK2H72DATCKQJT73,SQ863H9643DQ94C96,ST95HQJT8DJ876CA5|sv|b|mb|p|mb|p|mb|1C!|mb|p|mb|1H|mb|p|mb|2N!|mb|p|mb|3N|mb|p|mb|p|mb|p|pg||
pc|s3|pc|sT|pc|sJ|pc|sA|pg||
pc|c3|pc|c6|pc|cA|pc|c2|pg||
pc|hQ|pc|hK|pc|h2|pc|h3|pg||
pc|s7|pc|s2|pc|sQ|pc|s5|pg||
pc|s8|pc|s9|pc|s4|pc|sK|pg||
pc|cK|pc|c9|pc|c5|pc|c4|pg||
pc|cQ|pc|h4|pc|d6|pc|c8|pg||
pc|cJ|pc|h9|pc|d7|pc|d2|pg||
pc|cT|pc|d4|pc|h8|pc|d3|pg||
pc|c7|pc|h6|pc|dJ|pc|h5|pg||
pc|dA|pc|d9|pc|d8|pc|d5|pg||
mc|9|pg||
qx|c10|st||md|4SJ74HAK5DK532C842,SAK2H72DATCKQJT73,SQ863H9643DQ94C96,ST95HQJT8DJ876CA5|sv|b|mb|p|mb|p|mb|1C!|an|+2!C|mb|p|mb|1H|mb|p|mb|2N|mb|p|mb|3N|mb|p|mb|p|mb|p|pg||
pc|s3|pc|sT|pc|sJ|pc|sA|pg||
pc|h2|pc|h3|pc|hQ|pc|hK|pg||
pc|s7|pc|s2|pc|sQ|pc|s5|pg||
pc|s8|pc|s9|pc|s4|pc|sK|pg||
pc|c3|pc|c6|pc|cA|pc|c2|pg||
pc|c5|pc|c4|pc|cK|pc|c9|pg||
pc|cQ|pc|d4|pc|d6|pc|c8|pg||
pc|cJ|pc|d9|pc|d7|pc|d2|pg||
pc|cT|pc|s6|pc|d8|pc|h5|pg||
pc|c7|pc|dQ|pc|dJ|pc|d3|pg||
pc|dA|pc|h4|pc|h8|pc|d5|pg||
mc|9|pg||