vg|1st World Youth Congress,RR2-B,I,11,20,CKIS SKAWINA,0,NED GIRLS,0|
rs|3HW=,2NE+1,5HN=,5HN-1,4HS=,4HS=,6HN-2,4HN+2,1NE=,2NE-1,1NW=,2DW-2,1NE-1,2DE-2,2NE-2,3NE-4,1NE+3,5CE-2,2SW+2,2SW+1|
pn|Krysa A.,Dekkers L.,Zmuda J.,Nab J.,S.Spangenb,A.Janeczko,J.Spangenb,A.Szczcypc|pg||
qx|o11|st||md|1SJ863HKJ65D843CQT,S972HAQT732DT2CAJ,SKT54H8DKQJ7CK543,SAQH94DA965C98762|sv|o|mb|p|mb|1H|mb|d|mb|r|mb|1S|mb|2H|mb|p|mb|2N|mb|p|mb|3H|mb|p|mb|p|mb|p|pg||
pc|dK|pc|dA|pc|d8|pc|d2|pg||
pc|c2|pc|cT|pc|cA|pc|c3|pg||
pc|s2|pc|s4|pc|sQ|pc|s3|pg||
pc|sA|pc|s6|pc|s7|pc|s5|pg||
pc|d5|pc|d3|pc|dT|pc|dJ|pg||
pc|h8|pc|h4|pc|h5|pc|hT|pg||
pc|s9|pc|sT|pc|h9|pc|s8|pg||
pc|d6|pc|d4|pc|h2|pc|d7|pg||
pc|hA|pc|c4|pc|c6|pc|h6|pg||
pc|cJ|pc|c5|pc|c7|pc|cQ|pg||
pc|sJ|pc|h3|pc|sK|pc|c8|pg||
mc|9|pg||
qx|c11|st||md|1SJ863HKJ65D843CQT,S972HAQT732DT2CAJ,SKT54H8DKQJ7CK543,SAQH94DA965C98762|sv|o|mb|p|mb|1H|mb|d|mb|p|mb|1S|mb|2H|mb|p|mb|p|mb|2S|mb|p|mb|p|mb|2N|mb|p|mb|p|mb|p|pg||
pc|s6|pc|s2|pc|sK|pc|sA|pg||
pc|h9|pc|h6|pc|h2|pc|h8|pg||
pc|h4|pc|hJ|pc|hQ|pc|c5|pg||
pc|hA|pc|c3|pc|c2|pc|h5|pg||
pc|h3|pc|s4|pc|c6|pc|hK|pg||
pc|d8|pc|d2|pc|dJ|pc|dA|pg||
pc|c7|pc|cT|pc|cA|pc|c4|pg||
pc|hT|pc|s5|pc|d5|pc|d3|pg||
pc|h7|pc|sT|pc|d6|pc|s3|pg||
pc|s7|pc|d7|pc|sQ|pc|s8|pg||
pc|c8|pc|cQ|pc|cJ|pc|cK|pg||
mc|9|pg||
qx|o12|st||md|2SAT98HT8543DQT65C,SJ754H62DAJ7CQT42,S62HAKQJ97DK83CK5,SKQ3HD942CAJ98763|sv|n|mb|p|mb|1H|mb|4C|mb|4H|mb|5C|mb|5H|mb|p|mb|p|mb|p|pg||
pc|cA|pc|h3|pc|c4|pc|c5|pg||
pc|h4|pc|h2|pc|hA|pc|c9|pg||
pc|hK|pc|c8|pc|h5|pc|h6|pg||
pc|cK|pc|c3|pc|d5|pc|c2|pg||
pc|s2|pc|s3|pc|s8|pc|sJ|pg||
pc|dA|pc|d3|pc|d9|pc|d6|pg||
mc|11|pg||
qx|c12|st||md|2SAT98HT8543DQT65C,SJ754H62DAJ7CQT42,S62HAKQJ97DK83CK5,SKQ3HD942CAJ98763|sv|n|mb|p|mb|1H|mb|5C|mb|5H|mb|p|mb|p|mb|p|pg||
pc|cA|pc|h3|pc|c2|pc|c5|pg||
pc|h4|pc|h6|pc|hA|pc|c8|pg||
pc|hK|pc|c3|pc|h5|pc|h2|pg||
pc|s2|pc|s3|pc|s8|pc|sJ|pg||
pc|s5|pc|s6|pc|sQ|pc|sA|pg||
pc|d5|pc|d7|pc|dK|pc|d2|pg||
pc|cK|pc|c6|pc|h8|pc|c4|pg||
pc|s9|pc|s7|pc|d3|pc|sK|pg||
pc|d4|pc|d6|pc|dJ|pc|d8|pg||
mc|10|pg||
qx|o13|st||md|3SA74HKQT65DAJ5C62,ST85H7DKQT42CA943,SK9632HA9432D3C75,SQJHJ8D9876CKQJT8|sv|b|mb|2C|an|alerted|mb|p|mb|4H|mb|p|mb|p|mb|p|pg||
pc|dK|pc|d3|pc|d6|pc|dA|pg||
pc|hK|pc|h7|pc|h2|pc|h8|pg||
pc|hQ|pc|d2|pc|h3|pc|hJ|pg||
pc|s4|pc|s5|pc|s2|pc|sJ|pg||
pc|cK|pc|c2|pc|c3|pc|c5|pg||
pc|cT|pc|c6|pc|c4|pc|c7|pg||
mc|10|pg||
qx|c13|st||md|3SA74HKQT65DAJ5C62,ST85H7DKQT42CA943,SK9632HA9432D3C75,SQJHJ8D9876CKQJT8|sv|b|mb|p|mb|p|mb|1H|mb|2D|mb|4D!|mb|p|mb|4H|mb|p|mb|p|mb|p|pg||
pc|h7|pc|h2|pc|hJ|pc|hQ|pg||
pc|hK|pc|d2|pc|h3|pc|h8|pg||
pc|s4|pc|s5|pc|s6|pc|sQ|pg||
pc|cK|pc|c2|pc|c3|pc|c5|pg||
pc|cQ|pc|c6|pc|c4|pc|c7|pg||
pc|d8|mc|10|pg||
qx|o14|st||md|4SAQ987HAQ4DT93CA6,SKT654HJ865DQCKT5,SHKT972DAK542CQ83,SJ32H3DJ876CJ9742|sv|o|mb|p|mb|1S|mb|p|mb|2H|an|alerted|mb|p|mb|3H|mb|p|mb|4D!|an|cuebid|mb|p|mb|4S|mb|p|mb|5D|mb|p|mb|6C|mb|d|mb|6H|mb|p|mb|p|mb|p|pg||
pc|c4|pc|cA|pc|c5|pc|c3|pg||
pc|c6|pc|cK|pc|c8|pc|c2|pg||
pc|cT|pc|cQ|pc|c7|pc|d3|pg||
pc|h2|pc|h3|pc|hA|pc|h5|pg||
pc|d9|pc|dQ|pc|dA|pc|d6|pg||
pc|dK|pc|d7|pc|dT|pc|h6|pg||
pc|h8|pc|h9|pc|c9|pc|h4|pg||
pc|d2|pc|d8|pc|hQ|pc|s4|pg||
pc|sA|pc|s5|pc|d4|pc|s3|pg||
pc|s7|pc|sT|pc|h7|pc|s2|pg||
pc|d5|pc|dJ|pc|s8|pc|s6|pg||
mc|10|pg||
qx|c14|st||md|4SAQ987HAQ4DT93CA6,SKT654HJ865DQCKT5,SHKT972DAK542CQ83,SJ32H3DJ876CJ9742|sv|o|mb|p|mb|1S|mb|p|mb|2H|mb|2N!|mb|3C!|mb|d|mb|3N|mb|p|mb|4H|mb|p|mb|p|mb|p|pg||
pc|c4|pc|c6|pc|cK|pc|c3|pg||
pc|dQ|pc|dA|pc|d6|pc|d3|pg||
pc|h2|pc|h3|pc|hA|pc|h5|pg||
pc|hQ|pc|h6|pc|h7|pc|c2|pg||
pc|h4|pc|h8|pc|h9|pc|c7|pg||
pc|hK|pc|c9|pc|s7|pc|hJ|pg||
pc|d2|pc|d8|pc|d9|pc|s5|pg||
pc|sA|pc|s4|pc|d4|pc|s2|pg||
pc|cA|pc|c5|pc|c8|pc|cJ|pg||
pc|dT|pc|s6|mc|12|pg||
qx|o15|st||md|1S54HJ92DT962CA543,ST873H854DQ83CJT8,SJ962HKQ76DAJ5CQ6,SAKQHAT3DK74CK972|sv|n|mb|p|mb|p|mb|1C!|mb|d|mb|p!|mb|1S|mb|p|mb|1N|mb|p|mb|p|mb|p|pg||
pc|d9|pc|d3|pc|d5|pc|dK|pg||
pc|sA|pc|s4|pc|s3|pc|s2|pg||
pc|sK|pc|s5|pc|s7|pc|s6|pg||
pc|c2|pc|c3|pc|c8|pc|cQ|pg||
pc|s9|pc|sQ|pc|c4|pc|s8|pg||
pc|c7|pc|c5|pc|cT|pc|c6|pg||
pc|cJ|pc|h6|pc|c9|pc|cA|pg||
pc|d2|pc|dQ|pc|dA|pc|d4|pg||
pc|dJ|pc|d7|pc|d6|pc|d8|pg||
pc|sJ|pc|h3|pc|dT|pc|sT|pg||
pc|hK|pc|hA|pc|h2|pc|h4|pg||
mc|7|pg||
qx|c15|st||md|1S54HJ92DT962CA543,ST873H854DQ83CJT8,SJ962HKQ76DAJ5CQ6,SAKQHAT3DK74CK972|sv|n|mb|p|mb|p|mb|1D|mb|d|mb|p|mb|1S|mb|p|mb|2N|mb|p|mb|p|mb|p|pg||
pc|dT|pc|d3|pc|d5|pc|dK|pg||
pc|sA|pc|s5|pc|s3|pc|s2|pg||
pc|sK|pc|s4|pc|s7|pc|s6|pg||
pc|sQ|pc|c4|pc|s8|pc|s9|pg||
pc|c2|pc|c3|pc|cJ|pc|cQ|pg||
pc|sJ|pc|d4|pc|c5|pc|sT|pg||
pc|c6|pc|c7|pc|cA|pc|c8|pg||
pc|d2|pc|d8|pc|dJ|pc|d7|pg||
pc|hK|pc|hA|pc|h2|pc|h4|pg||
pc|cK|pc|d9|pc|cT|pc|h6|pg||
pc|c9|pc|d6|pc|h5|pc|h7|pg||
pc|h3|pc|h9|pc|h8|pc|hQ|pg||
pc|dA|pc|hT|pc|hJ|pc|dQ|pg||
pg||
qx|o16|st||md|2SK95H62DJ82CAJT83,S732H5DAQT64CQ954,SAJ6HAJ983D9753C6,SQT84HKQT74DKCK72|sv|e|mb|p|mb|p|mb|1H|mb|p|mb|1N|mb|p|mb|p|mb|p|pg||
pc|h3|pc|hK|pc|h2|pc|h5|pg||
pc|dK|pc|d2|pc|d4|pc|d3|pg||
pc|s4|pc|s5|pc|s7|pc|sJ|pg||
pc|c6|pc|c2|pc|cT|pc|cQ|pg||
pc|dA|pc|d5|pc|h4|pc|d8|pg||
pc|dQ|pc|d7|pc|s8|pc|dJ|pg||
pc|dT|pc|d9|pc|h7|pc|c3|pg||
pc|d6|pc|h8|pc|sT|pc|c8|pg||
pc|c4|pc|h9|pc|c7|pc|cJ|pg||
pc|cA|pc|c5|pc|s6|pc|cK|pg||
pc|h6|mc|7|pg||
qx|c16|st||md|2SK95H62DJ82CAJT83,S732H5DAQT64CQ954,SAJ6HAJ983D9753C6,SQT84HKQT74DKCK72|sv|e|mb|p|mb|1H|mb|d|mb|1N|mb|2D|mb|p|mb|p|mb|p|pg||
pc|c6|pc|c2|pc|cT|pc|cQ|pg||
pc|h5|pc|hA|pc|h4|pc|h6|pg||
pc|sA|pc|s4|pc|s5|pc|s7|pg||
pc|s6|pc|s8|pc|sK|pc|s2|pg||
pc|cA|pc|c4|pc|sJ|pc|c7|pg||
pc|c3|pc|c5|pc|d3|pc|cK|pg||
pc|h3|pc|hK|pc|h2|pc|s3|pg||
pc|hQ|pc|dJ|pc|dQ|pc|h8|pg||
pc|c9|pc|h9|pc|dK|pc|c8|pg||
pc|h7|pc|d8|pc|dT|pc|hJ|pg||
pc|dA|pc|d5|pc|hT|pc|d2|pg||
pc|d6|pc|d7|pc|sT|pc|s9|pg||
pc|d9|pc|sQ|pc|cJ|pc|d4|pg||
pg||
qx|o17|st||md|3S62HA7DAT974CJ974,SKQ97HT9642D5CAT2,SJT43HKQJ8DKJC653,SA85H53DQ8632CKQ8|sv|o|mb|p|mb|1D|mb|p|mb|1H|mb|p|mb|1N|mb|p|mb|p|mb|p|pg||
pc|c4|pc|c2|pc|c6|pc|cQ|pg||
pc|sA|pc|s2|pc|s7|pc|s4|pg||
pc|s5|pc|s6|pc|sK|pc|s3|pg||
pc|sQ|pc|sT|pc|s8|pc|d4|pg||
pc|hT|pc|hJ|pc|h3|pc|h7|pg||
pc|sJ|pc|d6|pc|d7|pc|s9|pg||
pc|c5|pc|cK|pc|c7|pc|cT|pg||
pc|h5|pc|hA|pc|h2|pc|h8|pg||
pc|c9|pc|cA|pc|c3|pc|c8|pg||
pc|d5|pc|dJ|pc|dQ|pc|dA|pg||
pc|cJ|pc|h4|pc|hK|pc|d2|pg||
mc|6|pg||
qx|c17|st||md|3S62HA7DAT974CJ974,SKQ97HT9642D5CAT2,SJT43HKQJ8DKJC653,SA85H53DQ8632CKQ8|sv|o|mb|1C|mb|1D|mb|1N|mb|d|mb|p|mb|2D|mb|p|mb|p|mb|p|pg||
pc|c7|pc|c2|pc|c3|pc|cK|pg||
pc|s5|pc|s6|pc|sK|pc|s4|pg||
pc|cA|pc|c5|pc|c8|pc|c4|pg||
pc|s7|pc|s3|pc|sA|pc|s2|pg||
pc|cQ|pc|c9|pc|cT|pc|c6|pg||
pc|s8|pc|d4|pc|s9|pc|sJ|pg||
pc|hA|pc|h2|pc|hK|pc|h3|pg||
pc|h7|pc|h9|pc|hJ|pc|h5|pg||
pc|h8|pc|d2|pc|d7|pc|h4|pg||
pc|cJ|pc|d5|pc|dK|pc|d3|pg||
pc|hQ|pc|d6|pc|d9|pc|h6|pg||
pc|dT|pc|hT|pc|dJ|pc|dQ|pg||
pc|d8|pc|dA|pc|sQ|pc|sT|pg||
pg||
qx|o18|st||md|4S5HK754DQT8CT7652,S643HQT86D7432CK9,SKQT972H32DJ95CAQ,SAJ8HAJ9DAK6CJ843|sv|n|mb|1C|an|alerted|mb|p|mb|1D|mb|1S|mb|2N|mb|p|mb|p|mb|p|pg||
pc|s5|pc|s3|pc|sQ|pc|s8|pg||
pc|s2|pc|sJ|pc|h7|pc|s4|pg||
pc|hJ|pc|h4|pc|h6|pc|h2|pg||
pc|hA|pc|h5|pc|h8|pc|h3|pg||
pc|h9|pc|hK|pc|hT|pc|d5|pg||
pc|c7|pc|c9|pc|cQ|pc|c3|pg||
pc|s9|pc|sA|pc|c2|pc|s6|pg||
pc|dA|pc|d8|pc|d2|pc|d9|pg||
pc|dK|pc|dT|pc|d3|pc|dJ|pg||
pc|c4|pc|c5|pc|cK|pc|cA|pg||
mc|6|pg||
qx|c18|st||md|4S5HK754DQT8CT7652,S643HQT86D7432CK9,SKQT972H32DJ95CAQ,SAJ8HAJ9DAK6CJ843|sv|n|mb|1C!|mb|p|mb|1D!|mb|2S|mb|d|mb|p|mb|3H|mb|p|mb|3N|mb|p|mb|p|mb|p|pg||
pc|s5|pc|s3|pc|sQ|pc|s8|pg||
pc|s7|pc|sJ|pc|c7|pc|s4|pg||
pc|hJ|pc|h4|pc|h6|pc|h3|pg||
pc|hA|pc|h5|pc|h8|pc|h2|pg||
pc|dA|pc|d8|pc|d2|pc|d5|pg||
pc|h9|pc|hK|pc|hT|pc|d9|pg||
pc|c5|pc|c9|pc|cQ|pc|c3|pg||
pc|s2|pc|sA|pc|h7|pc|s6|pg||
pc|c4|pc|c2|pc|cK|pc|cA|pg||
pc|sK|pc|d6|pc|c6|pc|d3|pg||
pc|sT|pc|c8|pc|cT|pc|d4|pg||
pc|s9|pc|dK|pc|dT|pc|d7|pg||
pc|dJ|pc|cJ|pc|dQ|pc|hQ|pg||
pg||
qx|o19|st||md|1SK9H752DJT982CJT5,SA763HQDK6543CAQ6,SQ542HAJ9863DA7C3,SJT8HKT4DQCK98742|sv|e|mb|p|mb|1D|mb|1H|mb|1N|mb|p|mb|p|mb|p|pg||
pc|h5|pc|hQ|pc|hA|pc|h4|pg||
pc|h8|pc|hT|pc|h2|pc|d3|pg||
pc|c2|pc|c5|pc|cA|pc|c3|pg||
pc|cQ|pc|h3|pc|c4|pc|cJ|pg||
pc|d4|pc|d7|pc|dQ|pc|dJ|pg||
pc|cK|pc|cT|pc|c6|pc|s2|pg||
pc|c9|pc|d2|pc|d5|pc|h6|pg||
pc|c7|pc|h7|pc|s3|pc|h9|pg||
pc|c8|pc|d8|pc|d6|pc|hJ|pg||
pc|hK|pc|d9|pc|dK|pc|s4|pg||
pc|sJ|pc|s9|pc|s6|pc|sQ|pg||
pc|dA|pc|s8|pc|dT|pc|s7|pg||
pc|s5|pc|sT|pc|sK|pc|sA|pg||
pg||
qx|c19|st||md|1SK9H752DJT982CJT5,SA763HQDK6543CAQ6,SQ542HAJ9863DA7C3,SJT8HKT4DQCK98742|sv|e|mb|p|mb|1D|mb|1H|mb|2C|mb|p|mb|4C|mb|p|mb|5C|mb|p|mb|p|mb|p|pg||
pc|h2|pc|hQ|pc|hA|pc|h4|pg||
pc|s4|pc|sT|pc|sK|pc|sA|pg||
pc|s3|pc|sQ|pc|s8|pc|s9|pg||
pc|dA|pc|dQ|pc|dJ|pc|d3|pg||
pc|s2|pc|sJ|pc|c5|pc|s6|pg||
pc|dT|pc|dK|pc|d7|pc|hT|pg||
pc|cA|pc|c3|pc|c2|pc|cT|pg||
pc|cQ|pc|h3|pc|c4|pc|cJ|pg||
mc|9|pg||
qx|o20|st||md|2SA54HKT86D63CKQ96,SKQ9632HJ32DQ8CJ8,S7HAQ54DJT52C7532,SJT8H97DAK974CAT4|sv|b|mb|2D!|mb|p|mb|2H|mb|p|mb|2S|mb|p|mb|p|mb|p|pg||
pc|dJ|pc|d4|pc|d3|pc|dQ|pg||
pc|s2|pc|s7|pc|sJ|pc|s4|pg||
pc|sT|pc|sA|pc|s3|pc|c7|pg||
pc|h6|pc|h2|pc|hQ|pc|h7|pg||
pc|hA|pc|h9|pc|h8|pc|h3|pg||
pc|c5|pc|cA|pc|c6|pc|c8|pg||
pc|dA|pc|d6|pc|d8|pc|d2|pg||
pc|d7|pc|c9|pc|sK|pc|d5|pg||
pc|s6|pc|c2|pc|s8|pc|s5|pg||
mc|10|pg||
qx|c20|st||md|2SA54HKT86D63CKQ96,SKQ9632HJ32DQ8CJ8,S7HAQ54DJT52C7532,SJT8H97DAK974CAT4|sv|b|mb|2D!|mb|p|mb|2H!|mb|p|mb|2S|mb|p|mb|p|mb|p|pg||
pc|dJ|pc|d4|pc|d6|pc|dQ|pg||
pc|s2|pc|s7|pc|s8|pc|sA|pg||
pc|hK|pc|h2|pc|h4|pc|h7|pg||
pc|h6|pc|h3|pc|hQ|pc|h9|pg||
pc|d2|pc|dA|pc|d3|pc|d8|pg||
pc|sT|pc|s4|pc|sQ|pc|c7|pg||
pc|hJ|pc|h5|pc|sJ|pc|h8|pg||
pc|cA|pc|c6|pc|c8|pc|c2|pg||
pc|dK|pc|s5|pc|s6|pc|d5|pg||
mc|9|pg||