vg|1st World Youth Congress,RR12-B,I,21,30,USA RED,0,NONAME,0|
rs|5CEx-1,5CEx-1,3NN-1,3NN=,3NN+1,3NN+1,1NN-3,2HE-2,5CS=,5CS+1,2HS+1,2HS+1,2CW-1,1NN=,2SW=,2SW=,4HN=,4HN+1,6CW=,6HEx-2|
pn|Z.Brescoll,A.Ozer,O.Lien,E.Serdar,S.SOFU,A.HUDSON,L.IMAMOGLU,J.MARRIOTT|pg||
qx|o21|st||md|3SKQ65HATDAQJT8CQ6,SJT72HQ9863D3CAT8,S843H7542DK97542C,SA9HKJD6CKJ975432|sv|n|mb|p|mb|1C!|mb|d|mb|1D!|an|4+h|mb|2D|mb|3C|mb|3D|mb|d|mb|p|mb|5C|mb|d|mb|p|mb|p|mb|p|pg||
pc|sK|pc|s2|pc|s8|pc|sA|pg||
pc|s9|pc|sQ|pc|s7|pc|s3|pg||
pc|hA|pc|h3|pc|h2|pc|hJ|pg||
pc|dA|pc|d3|pc|d2|pc|d6|pg||
pc|dT|pc|c8|pc|d4|mc|10|pg||
qx|c21|st||md|3SKQ65HATDAQJT8CQ6,SJT72HQ9863D3CAT8,S843H7542DK97542C,SA9HKJD6CKJ975432|sv|n|mb|p|mb|2C!|an|4+!c .could have longer side suit.11-15|mb|2D!|an|hearts or othe
rs|mb|d!|mb|4D|mb|5C|mb|d|mb|p|mb|p|mb|p|pg||
pc|dA|pc|d3|pc|d5|pc|d6|pg||
pc|sK|pc|s2|pc|s8|pc|sA|pg||
pc|c2|pc|c6|pc|cA|pc|d7|pg||
pc|c8|pc|d2|pc|cK|pc|cQ|pg||
pc|cJ|pc|dQ|pc|cT|pc|d4|pg||
pc|c9|pc|d8|pc|h3|pc|h2|pg||
pc|c7|pc|s6|pc|h6|pc|h4|pg||
pc|c5|pc|dT|pc|h8|pc|d9|pg||
pc|c4|pc|s5|pc|h9|pc|s3|pg||
pc|hJ|pc|hT|pc|hQ|pc|h5|pg||
pc|s7|pc|s4|pc|s9|pc|sQ|pg||
pc|hA|pc|sT|pc|h7|pc|hK|pg||
pc|dJ|pc|sJ|pc|dK|pc|c3|pg||
pg||
qx|o22|st||md|4SQT97HJ87DKCAQ963,SK42H93D97432CKT7,SAJ5HAK42DQJ86C85,S863HQT65DAT5CJ42|sv|e|mb|p|mb|2D!|an|10-15 hcp short in diamond 3 suits|mb|p|mb|2N|mb|p|mb|3C|mb|p|mb|3D|mb|p|mb|3H|mb|p|mb|3N|mb|p|mb|p|mb|p|pg||
pc|d5|pc|dK|pc|d2|pc|d6|pg||
pc|s7|pc|s2|pc|sJ|pc|s3|pg||
pc|c5|pc|c2|pc|cQ|pc|cK|pg||
pc|d3|pc|dQ|pc|dA|pc|c3|pg||
pc|dT|pc|c6|pc|d4|pc|dJ|pg||
pc|c8|pc|c4|pc|cA|pc|c7|pg||
pc|s9|pc|s4|pc|s5|pc|s6|pg||
pc|sT|pc|sK|pc|sA|pc|s8|pg||
pc|d8|pc|h5|pc|c9|pc|d9|pg||
pc|d7|pc|h2|pc|cJ|pc|sQ|pg||
pc|cT|pc|h4|pc|h6|pc|h7|pg||
mc|8|pg||
qx|c22|st||md|4SQT97HJ87DKCAQ963,SK42H93D97432CKT7,SAJ5HAK42DQJ86C85,S863HQT65DAT5CJ42|sv|e|mb|p|mb|1C!|an|+2!C|mb|p|mb|1H|mb|p|mb|1S|mb|p|mb|3N|mb|p|mb|p|mb|p|pg||
pc|s6|pc|s7|pc|sK|pc|sA|pg||
pc|c5|pc|c4|pc|cQ|pc|cK|pg||
pc|h9|pc|hA|pc|h5|pc|h7|pg||
pc|d6|pc|dA|pc|dK|pc|d7|pg||
pc|s3|pc|s9|pc|s4|pc|sJ|pg||
pc|s5|pc|s8|pc|sT|pc|s2|pg||
pc|sQ|pc|d2|pc|h2|pc|h6|pg||
pc|h8|pc|h3|pc|hK|pc|hT|pg||
pc|dQ|pc|d5|pc|c3|pc|d3|pg||
pc|dJ|pc|dT|pc|c6|pc|d4|pg||
pc|c8|pc|c2|pc|cA|pc|c7|pg||
mc|9|pg||
qx|o23|st||md|1SKT3H864DKQ3CQ654,SAJ85HQT753D8752C,SQ97HAK2DA96CKT97,S642HJ9DJT4CAJ832|sv|b|mb|p|mb|p|mb|1N|mb|p|mb|3N|mb|p|mb|p|mb|p|pg||
pc|c3|pc|c4|pc|d2|pc|c7|pg||
pc|s7|pc|s2|pc|sK|pc|sA|pg||
pc|h3|pc|hA|pc|h9|pc|h4|pg||
pc|cT|pc|cJ|pc|cQ|pc|d7|pg||
pc|c5|pc|d5|pc|c9|pc|cA|pg||
pc|hJ|pc|h6|pc|h5|pc|hK|pg||
pc|cK|pc|c2|pc|c6|pc|d8|pg||
pc|dA|pc|d4|pc|d3|pc|h7|pg||
pc|d6|pc|dT|pc|dQ|pc|s5|pg||
pc|dK|pc|hT|pc|d9|pc|dJ|pg||
pc|sT|pc|sJ|pc|sQ|pc|s6|pg||
mc|10|pg||
qx|c23|st||md|1SKT3H864DKQ3CQ654,SAJ85HQT753D8752C,SQ97HAK2DA96CKT97,S642HJ9DJT4CAJ832|sv|b|mb|p|mb|p|mb|1N|mb|p|mb|3N|mb|p|mb|p|mb|p|pg||
pc|c3|pc|c4|pc|d2|pc|c7|pg||
pc|c9|pc|cJ|pc|cQ|pc|d5|pg||
pc|s3|pc|s5|pc|sQ|pc|s6|pg||
pc|cT|pc|cA|pc|c6|pc|h3|pg||
pc|c2|pc|c5|pc|d7|pc|cK|pg||
pc|d6|pc|d4|pc|dK|pc|d8|pg||
pc|dQ|pc|h5|pc|d9|pc|dT|pg||
pc|d3|pc|s8|pc|dA|pc|dJ|pg||
pc|hA|pc|h9|pc|h4|pc|h7|pg||
pc|hK|pc|hJ|pc|h6|pc|hT|pg||
pc|h2|pc|s2|pc|h8|pc|hQ|pg||
pc|sA|pc|s7|pc|s4|pc|sT|pg||
pc|sJ|pc|s9|pc|c8|pc|sK|pg||
pg||
qx|o24|st||md|2SJ6H852DJT652CQT4,SQ9543HAT6DQ73CK2,SAT87H73DAK9CA987,SK2HKQJ94D84CJ653|sv|o|mb|p|mb|1N|mb|p|mb|p|mb|p|pg||
pc|hK|pc|h2|pc|hT|pc|h3|pg||
pc|hQ|pc|h5|pc|hA|pc|h7|pg||
pc|h6|pc|s7|pc|h9|pc|h8|pg||
pc|hJ|pc|c4|pc|s5|pc|c7|pg||
pc|h4|pc|cT|pc|s4|pc|c8|pg||
pc|c3|pc|cQ|pc|cK|pc|cA|pg||
pc|dA|pc|d4|pc|d2|pc|d3|pg||
pc|dK|pc|d8|pc|d5|pc|d7|pg||
pc|d9|pc|s2|pc|dT|pc|dQ|pg||
pc|c2|pc|c9|pc|cJ|pc|d6|pg||
pc|c6|pc|dJ|pc|s3|pc|s8|pg||
pc|c5|pc|s6|pc|s9|pc|sT|pg||
pc|sK|pc|sJ|pc|sQ|pc|sA|pg||
pg||
qx|c24|st||md|2SJ6H852DJT652CQT4,SQ9543HAT6DQ73CK2,SAT87H73DAK9CA987,SK2HKQJ94D84CJ653|sv|o|mb|1N!|mb|d!|mb|p!|an|FORCES TO xx|mb|p|mb|r!|an|forced|mb|p|mb|p|mb|2D|mb|p|mb|p|mb|2H|mb|p|mb|p|mb|p|pg||
pc|sJ|pc|s3|pc|s7|pc|sK|pg||
pc|s2|pc|s6|pc|s9|pc|sT|pg||
pc|h7|pc|hK|pc|h2|pc|h6|pg||
pc|c3|pc|c4|pc|cK|pc|cA|pg||
pc|dK|pc|d4|pc|d6|pc|d3|pg||
pc|h3|pc|h4|pc|h5|pc|hT|pg||
pc|c2|pc|c7|pc|cJ|pc|cQ|pg||
pc|h8|pc|hA|pc|s8|pc|h9|pg||
pc|s4|pc|sA|pc|c5|pc|d2|pg||
pc|dA|pc|d8|pc|d5|mc|6|pg||
qx|o25|st||md|3ST74HJ4D6CAKQJT95,S82HK9875DJ43C632,S9HA32DAQ8752C874,SAKQJ653HQT6DKT9C|sv|e|mb|1D!|mb|d|mb|r|mb|1H|mb|2D|mb|4S|mb|5C|mb|p|mb|p|mb|p|pg||
pc|s8|pc|s9|pc|sK|pc|s7|pg||
pc|hT|pc|hJ|pc|hK|pc|hA|pg||
pc|dA|pc|d9|pc|d6|pc|d3|pg||
pc|d2|pc|dT|pc|cA|pc|d4|pg||
pc|s4|pc|s2|pc|c4|pc|s3|pg||
pc|d5|pc|dK|pc|cK|pc|dJ|pg||
pc|cQ|pc|c2|pc|c7|pc|s5|pg||
pc|sT|pc|h5|pc|c8|pc|s6|pg||
pc|dQ|pc|sA|pc|h4|pc|c3|pg||
mc|11|pg||
qx|c25|st||md|3ST74HJ4D6CAKQJT95,S82HK9875DJ43C632,S9HA32DAQ8752C874,SAKQJ653HQT6DKT9C|sv|e|mb|1D|mb|3S!|an|opening hand with +6S|mb|4C|mb|p|mb|5C|mb|p|mb|p|mb|p|pg||
pc|s8|pc|s9|pc|sJ|pc|s7|pg||
pc|sA|pc|s4|pc|s2|pc|c4|pg||
pc|c7|pc|s3|pc|c5|pc|c3|pg||
pc|dA|pc|d9|pc|d6|pc|d4|pg||
pc|d2|pc|dT|pc|c9|pc|d3|pg||
pc|sT|pc|dJ|pc|c8|pc|s5|pg||
pc|d5|pc|dK|pc|cT|pc|h5|pg||
pc|cA|mc|12|pg||
qx|o26|st||md|4SKQ5HK8543D84CA95,ST62HQT7DAT3CKJT2,SJ98HAJ2DK9765C83,SA743H96DQJ2CQ764|sv|b|mb|p|mb|1H|mb|p|mb|2H!|mb|p|mb|p|mb|p|pg||
pc|s2|pc|s8|pc|sA|pc|s5|pg||
pc|s3|pc|sK|pc|s6|pc|s9|pg||
pc|c5|pc|cT|pc|c3|pc|cQ|pg||
pc|s7|pc|sQ|pc|sT|pc|sJ|pg||
pc|d4|pc|d3|pc|dK|pc|d2|pg||
pc|c8|pc|c4|pc|cA|pc|c2|pg||
pc|c9|pc|cJ|pc|h2|pc|c6|pg||
pc|d5|pc|dJ|pc|d8|pc|dT|pg||
pc|dQ|pc|h3|pc|dA|pc|d6|pg||
pc|h4|pc|h7|pc|hJ|pc|h6|pg||
pc|hA|pc|h9|pc|h5|pc|hT|pg||
pc|d7|pc|c7|pc|h8|pc|hQ|pg||
pc|cK|pc|d9|pc|s4|pc|hK|pg||
pg||
qx|c26|st||md|4SKQ5HK8543D84CA95,ST62HQT7DAT3CKJT2,SJ98HAJ2DK9765C83,SA743H96DQJ2CQ764|sv|b|mb|p|mb|1H|mb|p|mb|2H|mb|p|mb|p|mb|p|pg||
pc|s2|pc|s8|pc|sA|pc|s5|pg||
pc|s4|pc|sK|pc|s6|pc|s9|pg||
pc|d8|pc|d3|pc|dK|pc|d2|pg||
pc|c8|pc|c4|pc|c5|pc|cT|pg||
pc|sT|pc|sJ|pc|s3|pc|sQ|pg||
pc|cA|pc|c2|pc|c3|pc|c6|pg||
pc|c9|pc|cJ|pc|h2|pc|c7|pg||
pc|hA|pc|h6|pc|h3|pc|h7|pg||
pc|hJ|pc|h9|pc|hK|pc|hT|pg||
mc|9|pg||
qx|o27|st||md|1SAQT3H752DAQ5C982,S542HK8DJ982CAJ76,SK96HQT43D763CQT3,SJ87HAJ96DKT4CK54|sv|o|mb|1D!|mb|p|mb|1H|mb|p|mb|1S|mb|p|mb|1N|mb|d|mb|p|mb|2C|mb|p|mb|p|mb|p|pg||
pc|s6|pc|s7|pc|sT|pc|s2|pg||
pc|sA|pc|s4|pc|s9|pc|s8|pg||
pc|s3|pc|s5|pc|sK|pc|sJ|pg||
pc|d7|pc|d4|pc|dQ|pc|d2|pg||
pc|dA|pc|d8|pc|d3|pc|dT|pg||
pc|sQ|pc|c6|pc|d6|pc|dK|pg||
pc|hK|pc|h3|pc|h6|pc|h2|pg||
pc|h8|pc|h4|pc|hA|pc|h7|pg||
pc|h9|pc|h5|pc|c7|pc|hT|pg||
pc|d9|pc|hQ|pc|hJ|pc|d5|pg||
pc|dJ|pc|cT|pc|cK|pc|c2|pg||
mc|7|pg||
qx|c27|st||md|1SAQT3H752DAQ5C982,S542HK8DJ982CAJ76,SK96HQT43D763CQT3,SJ87HAJ96DKT4CK54|sv|o|mb|1C!|an|+2!c|mb|p|mb|1H|mb|p|mb|1S|mb|p|mb|1N|mb|p|mb|p|mb|p|pg||
pc|d4|pc|d5|pc|dJ|pc|d7|pg||
pc|d9|pc|d3|pc|dT|pc|dQ|pg||
pc|h2|pc|h8|pc|hT|pc|hJ|pg||
pc|dK|pc|dA|pc|d2|pc|d6|pg||
pc|h5|pc|hK|pc|h3|pc|h6|pg||
pc|d8|pc|s6|pc|s8|pc|c2|pg||
pc|c6|pc|c3|pc|cK|pc|c8|pg||
pc|s7|pc|s3|pc|s5|pc|sK|pg||
pc|s9|pc|sJ|pc|sA|pc|s2|pg||
pc|sQ|pc|s4|pc|h4|pc|h9|pg||
pc|sT|pc|c7|pc|hQ|pc|c4|pg||
pc|c9|pc|cA|pc|cT|pc|c5|pg||
pc|cJ|pc|cQ|pc|hA|pc|h7|pg||
pg||
qx|o28|st||md|2S9873HAKJ42DQCK42,SAQJ542HQ9DK4CQ76,ST6H753DT97653CA9,SKHT86DAJ82CJT853|sv|n|mb|1S|mb|p|mb|1N!|mb|p|mb|2S|mb|p|mb|p|mb|p|pg||
pc|cA|pc|c3|pc|c2|pc|cQ|pg||
pc|c9|pc|cJ|pc|cK|pc|c6|pg||
pc|hA|pc|h9|pc|h7|pc|h6|pg||
pc|c4|pc|c7|pc|s6|pc|c5|pg||
pc|h5|pc|h8|pc|hK|pc|hQ|pg||
pc|hJ|pc|s2|pc|h3|pc|hT|pg||
pc|s4|pc|sT|pc|sK|pc|s3|pg||
pc|d2|pc|dQ|pc|dK|pc|d3|pg||
pc|sA|mc|8|pg||
qx|c28|st||md|2S9873HAKJ42DQCK42,SAQJ542HQ9DK4CQ76,ST6H753DT97653CA9,SKHT86DAJ82CJT853|sv|n|mb|1S!|mb|p|mb|1N!|mb|p|mb|2S|mb|p|mb|p|mb|p|pg||
pc|dT|pc|dJ|pc|dQ|pc|dK|pg||
pc|d4|pc|d3|pc|d8|pc|s3|pg||
pc|hK|pc|h9|pc|h7|pc|h6|pg||
pc|hA|pc|hQ|pc|h3|pc|h8|pg||
pc|hJ|pc|s4|pc|h5|pc|hT|pg||
pc|s2|pc|s6|pc|sK|pc|s7|pg||
pc|dA|pc|s8|pc|sJ|pc|d5|pg||
pc|sA|pc|sT|pc|d2|pc|s9|pg||
pc|c6|pc|c9|pc|cJ|pc|cK|pg||
pc|h4|pc|s5|pc|d6|pc|c3|pg||
pc|cQ|pc|cA|pc|c5|pc|c2|pg||
pc|d7|pc|c8|pc|c4|pc|sQ|pg||
pc|c7|pc|d9|pc|cT|pc|h2|pg||
pg||
qx|o29|st||md|3S632HQ52DAJT72C43,SQ7HK9DK98654CJ87,SKT5HAJ743DCAK652,SAJ984HT86DQ3CQT9|sv|b|mb|1H|mb|1S|mb|2H|mb|p|mb|4H|mb|p|mb|p|mb|p|pg||
pc|h6|pc|h2|pc|h9|pc|hJ|pg||
pc|cA|pc|c9|pc|c3|pc|c7|pg||
pc|cK|pc|cT|pc|c4|pc|c8|pg||
pc|c2|pc|cQ|pc|h5|pc|cJ|pg||
pc|dA|pc|d4|pc|s5|pc|d3|pg||
pc|hQ|pc|hK|pc|hA|pc|h8|pg||
mc|10|pg||
qx|c29|st||md|3S632HQ52DAJT72C43,SQ7HK9DK98654CJ87,SKT5HAJ743DCAK652,SAJ984HT86DQ3CQT9|sv|b|mb|1H|mb|1S!|mb|2H|mb|p|mb|4H|mb|p|mb|p|mb|p|pg||
pc|h6|pc|h2|pc|hK|pc|hA|pg||
pc|cA|pc|c9|pc|c3|pc|c7|pg||
pc|cK|pc|cT|pc|c4|pc|c8|pg||
pc|c2|pc|cQ|pc|h5|pc|cJ|pg||
pc|hQ|pc|h9|pc|h3|pc|h8|pg||
pc|dA|pc|d4|pc|s5|pc|d3|pg||
pc|s2|pc|s7|pc|sK|pc|sA|pg||
pc|dQ|pc|d2|pc|d5|pc|h4|pg||
pc|hJ|pc|hT|pc|s3|pc|d6|pg||
mc|11|pg||
qx|o30|st||md|4SJ932HKJ432D643C4,SQ4HT5DA2CAKJT852,S765HDKQ9875C9763,SAKT8HAQ9876DJTCQ|sv|o|mb|1H|mb|p|mb|2C!|mb|3D|mb|3S|mb|4D|mb|6C|mb|p|mb|p|mb|p|pg||
pc|d5|pc|dT|pc|d6|pc|dA|pg||
pc|cA|mc|12|pg||
qx|c30|st||md|4SJ932HKJ432D643C4,SQ4HT5DA2CAKJT852,S765HDKQ9875C9763,SAKT8HAQ9876DJTCQ|sv|o|mb|1C!|mb|p|mb|2C!|an|+5!C GF.+12hcp|mb|2D|mb|2H|mb|p|mb|3C|mb|p|mb|3H|mb|p|mb|4N|mb|p|mb|5S|mb|p|mb|6H|mb|p|mb|p|mb|d|mb|p|mb|p|mb|p|pg||
pc|d4|pc|dA|pc|d5|pc|dT|pg||
pc|h5|pc|d7|pc|hA|pc|h4|pg||
pc|cQ|pc|c4|pc|cA|pc|c3|pg||
pc|cK|pc|c6|pc|dJ|pc|h2|pg||
pc|d3|pc|d2|pc|dQ|pc|h6|pg||
pc|h7|pc|hJ|pc|hT|pc|d8|pg||
pc|hK|pc|c2|pc|c7|pc|h8|pg||
pc|d6|pc|c5|pc|dK|pc|h9|pg||
mc|10|pg||