vg|1st World Youth Congress,RR 9-A,I,21,30,POLAND,0,GREECOURA,0|
rs|4HS+2,4HS=,1NN+1,2CNx=,4SS=,4SS=,4SN-1,4SNx-2,3NS=,3NS=,4SN+1,5SN=,3NS-1,3NS-1,3NS-1,1NS+1,1NN-1,1NN-2,3NS-2,4HN+1|
pn|Jassem,Doxiadis,Tuczynski,Kontomitro,ROUSSOS,JOCHYMSKI,DARKADAKIS,KAZMIERCZA|pg||
qx|o21|st||md|3S5HAK753DAT732C65,SKJ9HT9DQJ654CJ97,SQT87642HQJ82DCKT,SA3H64DK98CAQ8432|sv|n|mb|p|mb|2C|mb|2H|mb|3C|mb|4H|mb|p|mb|p|mb|p|pg||
pc|hT|pc|h2|pc|h4|pc|hA|pg||
pc|s5|pc|s9|pc|sT|pc|sA|pg||
pc|h6|pc|h3|pc|h9|pc|hQ|pg||
pc|s2|pc|s3|pc|h5|pc|sJ|pg||
pc|d2|pc|d4|pc|h8|pc|d8|pg||
pc|s4|pc|c2|pc|h7|pc|sK|pg||
pc|d3|pc|d5|pc|hJ|pc|d9|pg||
pc|sQ|pc|c3|pc|c5|pc|c9|pg||
pc|s8|pc|c4|pc|c6|mc|12|pg||
qx|c21|st||md|3S5HAK753DAT732C65,SKJ9HT9DQJ654CJ97,SQT87642HQJ82DCKT,SA3H64DK98CAQ8432|sv|n|mb|p|mb|1C!|mb|1H|mb|d|mb|r|mb|2C!|mb|2D|mb|p|mb|3H|mb|p|mb|4H|mb|p|mb|p|mb|p|pg||
pc|c9|pc|cT|pc|cQ|pc|c6|pg||
pc|cA|pc|c5|pc|cJ|pc|cK|pg||
pc|h4|pc|hA|pc|h9|pc|h2|pg||
pc|s5|pc|sK|pc|s2|pc|s3|pg||
pc|hT|pc|hQ|pc|h6|pc|h3|pg||
pc|s4|pc|sA|pc|hK|pc|s9|pg||
pc|h5|mc|10|pg||
qx|o22|st||md|4SAT5HQT743D82CJ85,SJ983HA9852D96CK7,SQ74HKDAJT7CA9642,SK62HJ6DKQ543CQT3|sv|e|mb|p|mb|p|mb|p|mb|1C|mb|1D|mb|d!|mb|1H|mb|1N|mb|p|mb|p|mb|p|pg||
pc|hJ|pc|h3|pc|h2|pc|hK|pg||
pc|cA|pc|c3|pc|c5|pc|c7|pg||
pc|c2|pc|cT|pc|cJ|pc|cK|pg||
pc|d9|pc|dJ|pc|dQ|pc|d2|pg||
pc|h6|pc|hQ|pc|hA|pc|s4|pg||
pc|d6|pc|dA|pc|d3|pc|d8|pg||
pc|c4|pc|cQ|pc|c8|pc|h5|pg||
pc|dK|pc|h4|pc|s3|pc|d7|pg||
pc|sK|pc|sA|mc|8|pg||
qx|o23|st||md|1SAT982HT3D5CK9762,SQ5HK976DQ93CAQT4,SKJ43HAQ2DAKT7C85,S76HJ854DJ8642CJ3|sv|b|mb|2S!|an|!S and a minor|mb|p|mb|2N|mb|p|mb|3C|mb|p|mb|4S|mb|p|mb|p|mb|p|pg||
pc|s5|pc|s3|pc|s6|pc|sT|pg||
pc|d5|pc|d3|pc|dA|pc|d4|pg||
pc|c5|pc|c3|pc|cK|pc|cA|pg||
pc|h7|pc|hA|pc|h5|pc|h3|pg||
pc|dK|pc|d2|pc|hT|pc|d9|pg||
pc|c8|pc|cJ|pc|c2|pc|c4|pg||
pc|h4|pc|s2|pc|h6|pc|h2|pg||
pc|c6|pc|cT|pc|sJ|pc|h8|pg||
pc|s4|pc|s7|pc|s8|pc|sQ|pg||
pc|hK|pc|hQ|pc|hJ|pc|s9|pg||
pc|c7|pc|cQ|pc|sK|pc|d6|pg||
mc|10|pg||
qx|c23|st||md|1SAT982HT3D5CK9762,SQ5HK976DQ93CAQT4,SKJ43HAQ2DAKT7C85,S76HJ854DJ8642CJ3|sv|b|mb|p|mb|1C!|mb|d|mb|p!|mb|2S|mb|p|mb|4S|mb|p|mb|p|mb|p|pg||
pc|h6|pc|hA|pc|h4|pc|h3|pg||
pc|dA|pc|d2|pc|d5|pc|d3|pg||
pc|dK|pc|d4|pc|hT|pc|d9|pg||
pc|h2|pc|h5|pc|s2|pc|h7|pg||
pc|c2|pc|c4|pc|c8|pc|cJ|pg||
pc|h8|pc|s8|pc|h9|pc|hQ|pg||
pc|s9|pc|s5|pc|sJ|pc|s6|pg||
pc|d7|pc|d8|pc|sT|pc|dQ|pg||
pc|sA|pc|sQ|pc|s3|pc|s7|pg||
mc|10|pg||
qx|o24|st||md|2SA962HQ543DA9873C,ST873HJT96DKQ5C98,SKQJ4H87D4CKQJ542,S5HAK2DJT62CAT763|sv|o|mb|p|mb|1C!|mb|p|mb|1H|mb|p|mb|1S|mb|p|mb|4C!|mb|p|mb|4D|mb|p|mb|4S|mb|p|mb|p|mb|p|pg||
pc|hA|pc|h3|pc|h6|pc|h8|pg||
pc|c3|pc|d3|pc|c8|pc|cJ|pg||
pc|cK|pc|cA|pc|s2|pc|c9|pg||
pc|s6|pc|s3|pc|sK|pc|s5|pg||
pc|c2|pc|c6|pc|sA|pc|dK|pg||
pc|s9|pc|sT|pc|sQ|pc|h2|pg||
pc|h7|pc|hK|pc|h4|pc|h9|pg||
pc|d2|pc|dA|pc|d5|pc|d4|pg||
pc|hQ|pc|hT|pc|c4|pc|d6|pg||
pc|h5|pc|hJ|pc|s4|pc|dT|pg||
pc|sJ|pc|dJ|pc|d7|pc|s7|pg||
pc|cQ|pc|c7|pc|d8|pc|s8|pg||
pc|dQ|pc|c5|pc|cT|pc|d9|pg||
pg||
qx|c24|st||md|2SA962HQ543DA9873C,ST873HJT96DKQ5C98,SKQJ4H87D4CKQJ542,S5HAK2DJT62CAT763|sv|o|mb|p|mb|1C|mb|p|mb|1D|mb|p|mb|1S|mb|p|mb|2S!|mb|p|mb|2N!|mb|p|mb|4S|mb|p|mb|p|mb|d|mb|p|mb|p|mb|p|pg||
pc|hA|pc|h3|pc|hT|pc|h7|pg||
pc|hK|pc|h4|pc|h6|pc|h8|pg||
pc|h2|pc|hQ|pc|h9|pc|c2|pg||
pc|s2|pc|s3|pc|sJ|pc|s5|pg||
pc|cK|pc|c3|pc|h5|pc|c8|pg||
pc|c4|pc|c6|pc|s6|pc|c9|pg||
pc|dA|pc|d5|pc|d4|pc|d2|pg||
pc|d3|pc|dK|pc|s4|pc|d6|pg||
pc|cQ|pc|cA|pc|s9|pc|sT|pg||
pc|s7|pc|sQ|pc|dT|pc|sA|pg||
pc|d7|pc|dQ|pc|sK|pc|dJ|pg||
pc|cJ|pc|c7|pc|d8|pc|s8|pg||
pc|hJ|pc|c5|pc|cT|pc|d9|pg||
pg||
qx|o25|st||md|3SQ52HK863D73CJT93,S76HQ75DJ84CK8642,SAJ84HAJ9DAKQT2C5,SKT93HT42D965CAQ7|sv|e|mb|1D|mb|p|mb|1H|mb|p|mb|2S|mb|p|mb|3N|mb|p|mb|p|mb|p|pg||
pc|c2|pc|c5|pc|cA|pc|c3|pg||
pc|cQ|pc|cJ|pc|c4|pc|s4|pg||
pc|c7|pc|c9|pc|cK|pc|s8|pg||
pc|c8|pc|sJ|pc|s3|pc|cT|pg||
pc|d3|pc|dJ|pc|dA|pc|d5|pg||
pc|dK|pc|d6|pc|d7|pc|d4|pg||
pc|dQ|pc|d9|pc|h3|pc|d8|pg||
pc|dT|pc|s9|pc|s2|pc|s6|pg||
pc|d2|pc|h2|pc|h6|pc|s7|pg||
pc|sA|pc|sT|pc|s5|pc|c6|pg||
pc|h9|pc|h4|pc|hK|pc|h5|pg||
pc|h8|pc|h7|pc|hA|pc|hT|pg||
pc|hJ|pc|sK|pc|sQ|pc|hQ|pg||
pg||
qx|c25|st||md|3SQ52HK863D73CJT93,S76HQ75DJ84CK8642,SAJ84HAJ9DAKQT2C5,SKT93HT42D965CAQ7|sv|e|mb|1D|mb|p|mb|1H|mb|p|mb|2S|mb|p|mb|3C!|mb|p|mb|3H|mb|p|mb|3N|mb|p|mb|p|mb|p|pg||
pc|c4|pc|c5|pc|cQ|pc|c3|pg||
pc|cA|pc|c9|pc|c2|pc|s4|pg||
pc|c7|pc|cJ|pc|cK|pc|s8|pg||
pc|s6|pc|sJ|pc|sK|pc|s2|pg||
pc|s3|pc|s5|pc|s7|pc|sA|pg||
pc|dA|pc|d6|pc|d3|pc|d4|pg||
pc|dK|pc|d5|pc|d7|pc|d8|pg||
pc|dQ|pc|d9|pc|h3|pc|dJ|pg||
mc|9|pg||
qx|o26|st||md|4S642HADA642CAK975,SQ9HT872DQJT3CQ43,SAJ853HKQJ3DK5CT8,SKT7H9654D987CJ62|sv|b|mb|p|mb|1C|mb|p|mb|1S|mb|p|mb|3C|mb|p|mb|3H|mb|p|mb|4S|mb|p|mb|p|mb|p|pg||
pc|d9|pc|dA|pc|d3|pc|d5|pg||
pc|hA|pc|h2|pc|h3|pc|h4|pg||
pc|s2|pc|s9|pc|sJ|pc|sK|pg||
pc|d7|pc|d2|pc|dT|pc|dK|pg||
pc|sA|pc|s7|pc|s4|pc|sQ|pg||
mc|11|pg||
qx|c26|st||md|4S642HADA642CAK975,SQ9HT872DQJT3CQ43,SAJ853HKQJ3DK5CT8,SKT7H9654D987CJ62|sv|b|mb|p|mb|1C|mb|p|mb|1S|mb|p|mb|2C|mb|p|mb|2H|mb|p|mb|2S|mb|p|mb|4S|mb|p|mb|4N|mb|p|mb|5C|mb|p|mb|5D|mb|p|mb|5S|mb|p|mb|p|mb|p|pg||
pc|d8|pc|dA|pc|dQ|pc|d5|pg||
pc|s2|pc|s9|pc|s3|pc|s7|pg||
pc|d3|pc|dK|pc|d7|pc|d2|pg||
pc|h3|pc|h4|pc|hA|pc|h2|pg||
pc|s4|pc|sQ|pc|sA|pc|sT|pg||
pc|s5|pc|sK|pc|s6|mc|11|pg||
qx|o27|st||md|1SKT74H76DA98CK985,SJ93HJDK652CQJ732,SAQ8HAT432DJ743CA,S652HKQ985DQTCT64|sv|o|mb|p|mb|p|mb|1H|mb|p|mb|1S|mb|p|mb|2D|mb|p|mb|2N|mb|p|mb|3S|mb|p|mb|3N|mb|p|mb|p|mb|p|pg||
pc|c2|pc|cA|pc|c6|pc|c5|pg||
pc|h2|pc|hQ|pc|h6|pc|hJ|pg||
pc|cT|pc|c8|pc|c3|pc|h3|pg||
pc|c4|pc|cK|pc|c7|pc|h4|pg||
pc|dA|pc|d2|pc|d3|pc|dT|pg||
pc|s4|pc|s3|pc|sA|pc|s2|pg||
pc|sQ|pc|s5|pc|s7|pc|s9|pg||
pc|s8|pc|s6|pc|sK|pc|sJ|pg||
pc|sT|pc|d5|pc|d4|pc|h5|pg||
pc|d8|pc|dK|pc|d7|pc|dQ|pg||
pc|cQ|pc|hT|pc|h8|pc|c9|pg||
pc|cJ|pc|hA|pc|h9|pc|d9|pg||
pc|d6|pc|dJ|pc|hK|pc|h7|pg||
pg||
qx|c27|st||md|1SKT74H76DA98CK985,SJ93HJDK652CQJ732,SAQ8HAT432DJ743CA,S652HKQ985DQTCT64|sv|o|mb|p|mb|p|mb|1H|mb|p|mb|1S|mb|1N!|mb|d|mb|2C!|mb|2N|mb|p|mb|3N|mb|p|mb|p|mb|p|pg||
pc|c3|pc|cA|pc|c6|pc|c5|pg||
pc|sA|pc|s6|pc|s4|pc|s3|pg||
pc|h2|pc|hK|pc|h6|pc|hJ|pg||
pc|cT|pc|c8|pc|c2|pc|h3|pg||
pc|c4|pc|cK|pc|c7|pc|d3|pg||
pc|h7|pc|d2|pc|hA|pc|h5|pg||
pc|sQ|pc|s2|pc|s7|pc|s9|pg||
pc|s8|pc|s5|pc|sK|pc|sJ|pg||
pc|sT|pc|d5|pc|h4|pc|h8|pg||
pc|d8|pc|dK|pc|d4|pc|dT|pg||
pc|cJ|pc|hT|pc|h9|pc|c9|pg||
pc|cQ|pc|d7|pc|hQ|pc|d9|pg||
pc|d6|pc|dJ|pc|dQ|pc|dA|pg||
pg||
qx|o28|st||md|2SAT8HAK7DA9754CK4,SJ76HQT42DJT6CJT8,SK952H65D83CQ7632,SQ43HJ983DKQ2CA95|sv|n|mb|p|mb|p|mb|1C!|mb|d|mb|p|mb|1D!|mb|p|mb|1N|mb|p|mb|2C|mb|p|mb|2D|mb|p|mb|2N|mb|p|mb|3N|mb|p|mb|p|mb|p|pg||
pc|h4|pc|h5|pc|hJ|pc|hK|pg||
pc|dA|pc|d6|pc|d3|pc|d2|pg||
pc|d4|pc|dT|pc|d8|pc|dQ|pg||
pc|h8|pc|h7|pc|h2|pc|h6|pg||
pc|h9|pc|hA|pc|hT|pc|c2|pg||
pc|d5|pc|dJ|pc|s2|pc|dK|pg||
pc|cA|pc|c4|pc|cJ|pc|c3|pg||
pc|h3|pc|s8|pc|hQ|pc|c6|pg||
mc|8|pg||
qx|c28|st||md|2SAT8HAK7DA9754CK4,SJ76HQT42DJT6CJT8,SK952H65D83CQ7632,SQ43HJ983DKQ2CA95|sv|n|mb|p|mb|p|mb|1C!|mb|d|mb|p!|mb|1S|mb|p|mb|1N|mb|p|mb|p|mb|p|pg||
pc|cJ|pc|c2|pc|c5|pc|cK|pg||
pc|d4|pc|dT|pc|d3|pc|d2|pg||
pc|h2|pc|h5|pc|hJ|pc|hK|pg||
pc|d5|pc|dJ|pc|d8|pc|dK|pg||
pc|h9|pc|h7|pc|h4|pc|h6|pg||
pc|h3|pc|hA|pc|hQ|pc|c3|pg||
pc|dA|pc|d6|pc|c6|pc|dQ|pg||
pc|d9|pc|c8|pc|c7|pc|s4|pg||
pc|d7|pc|cT|pc|cQ|pc|c9|pg||
pc|sA|pc|s6|pc|s2|pc|s3|pg||
pc|s8|pc|s7|pc|sK|pc|sQ|pg||
mc|8|pg||
qx|o29|st||md|3S9865H2DT942CJ965,SA3HK6DAQJ8CK7432,SKJTHQJ73DK7CAQT8,SQ742HAT9854D653C|sv|b|mb|1N|mb|p|mb|p|mb|p|pg||
pc|hT|pc|h2|pc|hK|pc|h3|pg||
pc|dJ|pc|dK|pc|d3|pc|d2|pg||
pc|cA|pc|s4|pc|c5|pc|c2|pg||
pc|cQ|pc|s7|pc|c6|pc|c3|pg||
pc|cT|pc|h4|pc|cJ|pc|cK|pg||
pc|c7|pc|c8|pc|s2|pc|c9|pg||
pc|s5|pc|s3|pc|sK|pc|sQ|pg||
pc|sJ|pc|h5|pc|s6|pc|sA|pg||
pc|dQ|pc|d7|pc|d5|pc|d4|pg||
pc|c4|pc|sT|pc|d6|pc|s8|pg||
pc|dA|pc|h7|pc|h8|pc|d9|pg||
pc|h6|pc|hJ|pc|hA|pc|dT|pg||
pc|h9|pc|s9|pc|d8|pc|hQ|pg||
pg||
qx|c29|st||md|3S9865H2DT942CJ965,SA3HK6DAQJ8CK7432,SKJTHQJ73DK7CAQT8,SQ742HAT9854D653C|sv|b|mb|1N|mb|p|mb|p|mb|p|pg||
pc|hT|pc|h2|pc|hK|pc|h3|pg||
pc|h6|pc|hJ|pc|hA|pc|c5|pg||
pc|h8|pc|c6|pc|c2|pc|hQ|pg||
pc|sK|pc|s2|pc|s5|pc|sA|pg||
pc|c4|pc|c8|pc|s4|pc|c9|pg||
pc|cJ|pc|c3|pc|cT|pc|d5|pg||
pc|s6|pc|s3|pc|sJ|pc|sQ|pg||
pc|h9|pc|d2|pc|c7|pc|h7|pg||
pc|h5|pc|d4|pc|cK|pc|cQ|pg||
pc|h4|pc|d9|pc|d8|mc|5|pg||
qx|o30|st||md|4SA84HJ98DAT8642CK,SKQ3HAT62DJ75C982,SJ5HKQ54DQ93CA643,ST9762H73DKCQJT75|sv|o|mb|p|mb|1D|mb|p|mb|1H|mb|p|mb|2D|mb|p|mb|3C|mb|p|mb|3H|mb|p|mb|3S|mb|p|mb|3N|mb|p|mb|p|mb|p|pg||
pc|sK|pc|s5|pc|s2|pc|s4|pg||
pc|sQ|pc|sJ|pc|s6|pc|s8|pg||
pc|s3|pc|c3|pc|s7|pc|sA|pg||
pc|cK|pc|c2|pc|c4|pc|c5|pg||
pc|h9|pc|h2|pc|hK|pc|h3|pg||
pc|dQ|pc|dK|pc|dA|pc|d5|pg||
pc|d2|pc|d7|pc|d9|pc|c7|pg||
pc|h4|pc|h7|pc|hJ|pc|hA|pg||
pc|hT|pc|hQ|pc|s9|pc|h8|pg||
pc|h5|pc|cT|pc|d4|pc|h6|pg||
pc|dJ|pc|d3|pc|sT|pc|d6|pg||
pc|c8|pc|cA|pc|cJ|pc|d8|pg||
pc|c6|pc|cQ|pc|dT|pc|c9|pg||
pg||
qx|c30|st||md|4SA84HJ98DAT8642CK,SKQ3HAT62DJ75C982,SJ5HKQ54DQ93CA643,ST9762H73DKCQJT75|sv|o|mb|p|mb|1D|mb|p|mb|1H|mb|p|mb|2D|mb|p|mb|3C!|mb|p|mb|4H|mb|p|mb|p|mb|p|pg||
pc|h3|pc|h8|pc|hA|pc|h4|pg||
pc|hT|pc|h5|pc|h7|pc|hJ|pg||
pc|h9|pc|h2|pc|hQ|pc|s2|pg||
pc|dQ|pc|dK|pc|dA|pc|d7|pg||
pc|d2|pc|d5|pc|d9|pc|s6|pg||
pc|hK|pc|s7|pc|s4|pc|h6|pg||
pc|c3|pc|c5|pc|cK|pc|c2|pg||
pc|d4|pc|dJ|pc|d3|pc|c7|pg||
pc|c9|pc|cA|mc|11|pg||