vg|1st World Youth Congress,RR13-B,I,1,10,NED GIRLS,0,NONAME,0|
rs|4DE=,4SS-3,1NW-1,1NE+1,5SE-1,6SEx-2,3NW+1,3NW+3,2NE-1,2SE=,1HE+2,2HE-1,4HE-3,3HE-2,4SS=,4SN=,5CSx-1,5CN=,3NE=,3NW+1|
pn|S.Spangenb,A.Ozer,J.Spangenb,E.Serdar,S.SOFU,L.DEKKERS,L.IMAMOGLU,J.NAB|pg||
qx|o1|st||md|3SQT86HKQD854CJ752,S974HA4DT963C9843,SKJ53HJT98653DQCK,SA2H72DAKJ72CAQT6|sv|o|mb|1H|mb|d|mb|1S|mb|p|mb|2S|mb|3D|mb|3S|mb|4D|mb|p|mb|p|mb|p|pg||
pc|hK|pc|h4|pc|hJ|pc|h7|pg||
pc|s8|pc|s9|pc|sK|pc|sA|pg||
pc|dA|pc|d4|pc|d3|pc|dQ|pg||
pc|dK|pc|d5|pc|d6|pc|h3|pg||
pc|d2|pc|d8|pc|d9|pc|h5|pg||
pc|c3|pc|cK|pc|cA|pc|c7|pg||
pc|s2|pc|sT|pc|s4|pc|s3|pg||
pc|sQ|pc|s7|pc|s5|pc|d7|pg||
pc|h2|pc|hQ|pc|hA|pc|h6|pg||
pc|c9|pc|h8|pc|c6|pc|cJ|pg||
mc|10|pg||
qx|c1|st||md|3SQT86HKQD854CJ752,S974HA4DT963C9843,SKJ53HJT98653DQCK,SA2H72DAKJ72CAQT6|sv|o|mb|1H|mb|d|mb|1S|mb|p|mb|4S|mb|p|mb|p|mb|p|pg||
pc|dT|pc|dQ|pc|dK|pc|d5|pg||
pc|cA|pc|c5|pc|c9|pc|cK|pg||
pc|dA|pc|d8|pc|d6|pc|s3|pg||
pc|h3|pc|h2|pc|hK|pc|hA|pg||
pc|d3|pc|s5|pc|d2|pc|d4|pg||
pc|hJ|pc|h7|pc|hQ|pc|h4|pg||
pc|c2|pc|c4|pc|sJ|pc|c6|pg||
pc|hT|pc|d7|pc|c7|pc|s4|pg||
pc|s7|pc|sK|pc|sA|pc|s6|pg||
pc|dJ|pc|s8|pc|d9|pc|h5|pg||
pc|sQ|pc|s9|pc|h6|pc|s2|pg||
pc|sT|pc|c3|pc|h8|pc|cT|pg||
pc|cJ|pc|c8|pc|h9|pc|cQ|pg||
pg||
qx|o2|st||md|4ST873HKQ987DQ976C,SKQ9HA32DKT8CJT54,SA642H65DA43CA987,SJ5HJT4DJ52CKQ632|sv|n|mb|p|mb|p|mb|1C!|an|2+|mb|p|mb|1S!|mb|p|mb|1N|mb|p|mb|p|mb|p|pg||
pc|s4|pc|s5|pc|sT|pc|sQ|pg||
pc|cJ|pc|c8|pc|c2|pc|s8|pg||
pc|cT|pc|cA|pc|c3|pc|s7|pg||
pc|h6|pc|hJ|pc|hQ|pc|hA|pg||
pc|c5|pc|c7|pc|cK|pc|s3|pg||
pc|cQ|pc|d7|pc|c4|pc|c9|pg||
pc|c6|pc|d6|pc|d8|pc|d3|pg||
pc|sJ|pc|d9|pc|s9|pc|sA|pg||
pc|h5|pc|hT|pc|hK|pc|h2|pg||
pc|h9|pc|h3|pc|s6|pc|h4|pg||
pc|h8|pc|sK|pc|d4|pc|d2|pg||
pc|h7|pc|dT|pc|s2|pc|d5|pg||
pc|dQ|pc|dK|pc|dA|pc|dJ|pg||
pg||
qx|c2|st||md|4ST873HKQ987DQ976C,SKQ9HA32DKT8CJT54,SA642H65DA43CA987,SJ5HJT4DJ52CKQ632|sv|n|mb|p|mb|p|mb|1C!|an|+2!C|mb|p|mb|1N|mb|p|mb|p|mb|p|pg||
pc|h8|pc|h2|pc|h6|pc|hT|pg||
pc|c2|pc|s8|pc|cJ|pc|cA|pg||
pc|h5|pc|h4|pc|h7|pc|hA|pg||
pc|cT|pc|c9|pc|c3|pc|s7|pg||
pc|c4|pc|c7|pc|cK|pc|d6|pg||
pc|cQ|pc|h9|pc|c5|pc|c8|pg||
pc|c6|pc|s3|pc|h3|pc|d3|pg||
pc|sJ|pc|sT|pc|s9|pc|s2|pg||
pc|s5|pc|d7|pc|sQ|pc|sA|pg||
pc|s4|pc|d2|pc|hQ|pc|sK|pg||
pc|d8|pc|d4|pc|dJ|pc|dQ|pg||
pc|hK|pc|dT|pc|s6|pc|hJ|pg||
pc|d9|pc|dK|pc|dA|pc|d5|pg||
pg||
qx|o3|st||md|1S8H942DAKQT764CQ9,SKQ32HJ765DJ3C854,ST5HT83D9852CAKT6,SAJ9764HAKQDCJ732|sv|e|mb|3N|mb|p|mb|4C|mb|4S|mb|p|mb|p|mb|4N|mb|d|mb|5D|mb|5S|mb|p|mb|p|mb|p|pg||
pc|dA|pc|d3|pc|d2|pc|s4|pg||
pc|s6|pc|s8|pc|sK|pc|s5|pg||
pc|dJ|pc|d5|pc|s9|pc|d4|pg||
pc|sA|pc|d6|pc|s2|pc|sT|pg||
pc|hA|pc|h2|pc|h5|pc|h3|pg||
pc|hK|pc|h4|pc|h6|pc|h8|pg||
pc|hQ|pc|h9|pc|h7|pc|hT|pg||
pc|sJ|pc|d7|pc|sQ|pc|d8|pg||
pc|hJ|pc|c6|pc|c3|pc|dT|pg||
pc|c4|pc|cT|pc|c2|pc|c9|pg||
pc|cA|pc|c7|pc|cQ|pc|c5|pg||
pc|cK|pc|cJ|pc|dQ|pc|c8|pg||
pc|d9|pc|s7|pc|dK|pc|s3|pg||
pg||
qx|c3|st||md|1S8H942DAKQT764CQ9,SKQ32HJ765DJ3C854,ST5HT83D9852CAKT6,SAJ9764HAKQDCJ732|sv|e|mb|3N!|mb|p|mb|5C!|mb|5S|mb|p|mb|6S|mb|d|mb|p|mb|p|mb|p|pg||
pc|dA|pc|d3|pc|d2|pc|s4|pg||
pc|s6|pc|s8|pc|sK|pc|s5|pg||
pc|s2|pc|sT|pc|sA|pc|d4|pg||
mc|10|pg||
qx|o4|st||md|2S532HAK73DJT7C653,SAKJT9HQ94DQ6CKJ7,SQ7HT65D9542CT942,S864HJ82DAK83CAQ8|sv|b|mb|1S|mb|p|mb|2C!|an|0+ gf|mb|p|mb|2N!|mb|p|mb|3C|mb|p|mb|3S!|an|16+ good sp|mb|p|mb|3N|mb|p|mb|p|mb|p|pg||
pc|cT|pc|cA|pc|c6|pc|c7|pg||
pc|s4|pc|s5|pc|sK|pc|s7|pg||
pc|dQ|pc|d5|pc|d3|pc|dJ|pg||
pc|d6|pc|d2|pc|dA|pc|d7|pg||
pc|s6|pc|s2|pc|s9|pc|sQ|pg||
pc|d4|pc|dK|pc|dT|pc|h4|pg||
pc|s8|pc|s3|pc|sT|pc|h5|pg||
pc|sA|pc|h6|pc|h2|pc|h3|pg||
pc|sJ|pc|c2|pc|h8|pc|c5|pg||
pc|cK|pc|c4|pc|c8|pc|c3|pg||
pc|cJ|pc|c9|pc|cQ|pc|h7|pg||
mc|10|pg||
qx|c4|st||md|2S532HAK73DJT7C653,SAKJT9HQ94DQ6CKJ7,SQ7HT65D9542CT942,S864HJ82DAK83CAQ8|sv|b|mb|1N|mb|p|mb|3N|mb|p|mb|p|mb|p|pg||
pc|h6|pc|h2|pc|hK|pc|h4|pg||
pc|h7|pc|hQ|pc|h5|pc|h8|pg||
pc|sA|pc|s7|pc|s4|pc|s2|pg||
pc|dQ|pc|d2|pc|d3|pc|d7|pg||
pc|cK|pc|c2|pc|c8|pc|c6|pg||
pc|c7|pc|c4|pc|cQ|pc|c3|pg||
pc|cA|pc|c5|pc|cJ|pc|cT|pg||
pc|dA|pc|dT|pc|d6|pc|d4|pg||
pc|dK|pc|dJ|pc|h9|pc|d5|pg||
pc|s6|pc|s3|pc|sK|pc|sQ|pg||
mc|12|pg||
qx|o5|st||md|3S832HT2DKT863CK83,ST7654HAK94DCT964,SKQJHQ853DJ942CQJ,SA9HJ76DAQ75CA752|sv|n|mb|p|mb|1C|an|2+|mb|p|mb|2D!|mb|p|mb|2N!|mb|p|mb|p|mb|p|pg||
pc|d3|pc|c4|pc|dJ|pc|dQ|pg||
pc|sA|pc|s2|pc|s4|pc|sJ|pg||
pc|s9|pc|s3|pc|s5|pc|sK|pg||
pc|d2|pc|d5|pc|d6|pc|c6|pg||
pc|dT|pc|s6|pc|d4|pc|d7|pg||
pc|dK|pc|c9|pc|d9|pc|dA|pg||
pc|h6|pc|h2|pc|hA|pc|h3|pg||
pc|s7|pc|sQ|pc|c2|pc|s8|pg||
pc|cQ|pc|cA|pc|c3|pc|cT|pg||
pc|h7|pc|hT|pc|hK|pc|h5|pg||
pc|sT|mc|7|pg||
qx|c5|st||md|3S832HT2DKT863CK83,ST7654HAK94DCT964,SKQJHQ853DJ942CQJ,SA9HJ76DAQ75CA752|sv|n|mb|p|mb|1N|mb|p|mb|2C|mb|p|mb|2D|mb|p|mb|2H!|mb|p|mb|2S|mb|p|mb|p|mb|p|pg||
pc|s3|pc|s4|pc|sJ|pc|sA|pg||
pc|s9|pc|s2|pc|s5|pc|sQ|pg||
pc|d2|pc|dQ|pc|dK|pc|s6|pg||
pc|c4|pc|cQ|pc|cA|pc|c8|pg||
pc|c2|pc|c3|pc|cT|pc|cJ|pg||
pc|sK|pc|d5|pc|s8|pc|s7|pg||
pc|d4|pc|dA|pc|d3|pc|h4|pg||
pc|c5|pc|cK|pc|c9|pc|h3|pg||
pc|h2|pc|h9|pc|hQ|pc|h6|pg||
mc|8|pg||
qx|o6|st||md|4SK953H95DJ8762CA5,SJT642HJ43DT95CT2,SA7HQ76DA43CJ8643,SQ8HAKT82DKQCKQ97|sv|e|mb|1H|mb|p|mb|p|mb|p|pg||
pc|d2|pc|dT|pc|dA|pc|dQ|pg||
pc|sA|pc|s8|pc|s5|pc|s2|pg||
pc|s7|pc|sQ|pc|sK|pc|s4|pg||
pc|d6|pc|d5|pc|d3|pc|dK|pg||
pc|cQ|pc|cA|pc|c2|pc|c3|pg||
pc|c5|pc|cT|pc|cJ|pc|cK|pg||
pc|hA|pc|h5|pc|h3|pc|h6|pg||
pc|c7|pc|s9|pc|h4|pc|c4|pg||
pc|hJ|pc|h7|pc|h2|pc|h9|pg||
pc|d9|pc|d4|pc|h8|pc|d7|pg||
pc|hK|pc|s3|pc|s6|pc|hQ|pg||
mc|9|pg||
qx|c6|st||md|4SK953H95DJ8762CA5,SJT642HJ43DT95CT2,SA7HQ76DA43CJ8643,SQ8HAKT82DKQCKQ97|sv|e|mb|1H|mb|p|mb|p|mb|1N!|mb|2C|mb|d!|mb|2H|mb|p|mb|p|mb|p|pg||
pc|d6|pc|dT|pc|dA|pc|dK|pg||
pc|d3|pc|dQ|pc|d8|pc|d5|pg||
pc|hA|pc|h5|pc|h3|pc|h6|pg||
pc|hK|pc|h9|pc|h4|pc|h7|pg||
pc|sQ|pc|s3|pc|s2|pc|sA|pg||
pc|hQ|pc|h2|pc|s5|pc|hJ|pg||
pc|d4|pc|h8|pc|d2|pc|d9|pg||
pc|s8|pc|sK|pc|s4|pc|s7|pg||
pc|dJ|pc|s6|pc|c3|pc|hT|pg||
pc|cK|pc|cA|pc|c2|pc|c4|pg||
pc|d7|pc|cT|pc|c6|pc|c7|pg||
pc|c5|pc|sT|pc|c8|pc|c9|pg||
pc|cQ|pc|s9|pc|sJ|pc|cJ|pg||
pg||
qx|o7|st||md|1ST9432HA762DK3C93,SAKQJ7H3D987CJT54,S85HKDAQ642CKQ862,S6HQJT9854DJT5CA7|sv|b|mb|p|mb|1S|mb|2N!|an|alerted as mino
rs|mb|4H|mb|p|mb|p|mb|p|pg||
pc|dK|pc|d7|pc|d2|pc|dJ|pg||
pc|d3|pc|d8|pc|dA|pc|dT|pg||
pc|dQ|pc|d5|pc|c9|pc|d9|pg||
pc|d4|pc|h8|pc|s2|pc|s7|pg||
pc|s6|pc|s3|pc|sA|pc|s8|pg||
pc|sK|pc|s5|pc|c7|pc|s4|pg||
pc|sQ|pc|hK|pc|cA|pc|sT|pg||
pc|d6|pc|hQ|pc|s9|pc|c4|pg||
pc|hJ|pc|h2|pc|h3|pc|c2|pg||
pc|hT|pc|h6|pc|c5|pc|c6|pg||
mc|7|pg||
qx|c7|st||md|1ST9432HA762DK3C93,SAKQJ7H3D987CJT54,S85HKDAQ642CKQ862,S6HQJT9854DJT5CA7|sv|b|mb|p|mb|1S|mb|2N!|mb|p|mb|3C|mb|p|mb|p|mb|3H|mb|p|mb|p|mb|p|pg||
pc|dK|pc|d7|pc|d2|pc|d5|pg||
pc|d3|pc|d8|pc|dQ|pc|dT|pg||
pc|dA|pc|dJ|pc|c3|pc|d9|pg||
pc|d4|pc|h9|pc|c9|pc|c4|pg||
pc|s6|pc|s2|pc|sA|pc|s5|pg||
pc|sK|pc|s8|pc|c7|pc|s3|pg||
pc|c5|pc|c2|pc|cA|pc|h2|pg||
pc|s4|pc|s7|pc|hK|pc|h4|pg||
pc|cQ|pc|h8|pc|s9|pc|cT|pg||
mc|7|pg||
qx|o8|st||md|2SAQT975H76D73CT86,S62HKJTDJT852C754,SK8HA43DAQ96CAQ32,SJ43HQ9852DK4CKJ9|sv|o|mb|p|mb|1C|mb|1H|mb|2S|mb|p|mb|2N!|mb|p|mb|3S!|an|good sp few hcp|mb|p|mb|4S|mb|p|mb|p|mb|p|pg||
pc|hK|pc|h3|pc|h2|pc|h6|pg||
pc|c5|pc|c2|pc|cJ|pc|c6|pg||
pc|hQ|pc|h7|pc|hJ|pc|hA|pg||
pc|sK|pc|s3|pc|s5|pc|s2|pg||
pc|s8|pc|s4|pc|sA|pc|s6|pg||
pc|sQ|pc|d2|pc|d6|pc|sJ|pg||
pc|cT|pc|c4|pc|c3|pc|cK|pg||
pc|h5|mc|10|pg||
qx|c8|st||md|2SAQT975H76D73CT86,S62HKJTDJT852C754,SK8HA43DAQ96CAQ32,SJ43HQ9852DK4CKJ9|sv|o|mb|p|mb|2N|mb|p|mb|4D!|mb|p|mb|4S|mb|p|mb|p|mb|p|pg||
pc|h9|pc|h6|pc|hK|pc|hA|pg||
pc|sK|pc|s3|pc|s5|pc|s2|pg||
pc|s8|pc|s4|pc|sA|pc|s6|pg||
pc|sQ|pc|d8|pc|h3|pc|sJ|pg||
pc|c6|pc|c7|pc|cQ|pc|cK|pg||
pc|h5|pc|h7|pc|hJ|pc|h4|pg||
pc|hT|pc|d6|pc|h2|pc|s7|pg||
pc|cT|pc|c4|pc|c2|pc|cJ|pg||
pc|hQ|pc|s9|pc|c5|pc|d9|pg||
pc|c8|pc|d2|pc|cA|pc|c9|pg||
pc|c3|pc|h8|pc|d3|pc|d5|pg||
mc|10|pg||
qx|o9|st||md|3S75HAKQ6DT54CQ972,ST3H98543DAKJCK63,SAK864HD962CAT854,SQJ92HJT72DQ873CJ|sv|e|mb|1S|mb|p|mb|2C!|mb|p|mb|2S!|mb|p|mb|2N|mb|p|mb|5C|mb|p|mb|p|mb|d|mb|p|mb|p|mb|p|pg||
pc|dK|pc|d2|pc|d7|pc|dT|pg||
pc|dA|pc|d6|pc|d3|pc|d4|pg||
pc|dJ|pc|d9|pc|dQ|pc|d5|pg||
pc|hJ|pc|hA|pc|h3|pc|s4|pg||
pc|cQ|pc|cK|pc|cA|pc|cJ|pg||
pc|c4|pc|d8|pc|c7|pc|c3|pg||
pc|c9|pc|c6|pc|c5|pc|h2|pg||
mc|10|pg||
qx|c9|st||md|3S75HAKQ6DT54CQ972,ST3H98543DAKJCK63,SAK864HD962CAT854,SQJ92HJT72DQ873CJ|sv|e|mb|1S|mb|p|mb|1N!|mb|p|mb|2C|mb|p|mb|3C|mb|p|mb|4C|mb|p|mb|4H|mb|p|mb|5C|mb|p|mb|p|mb|p|pg||
pc|hJ|pc|hA|pc|h5|pc|d2|pg||
pc|hK|pc|h3|pc|d6|pc|h2|pg||
pc|hQ|pc|h4|pc|d9|pc|h7|pg||
pc|c2|pc|c6|pc|cA|pc|cJ|pg||
pc|c4|pc|d3|pc|cQ|pc|cK|pg||
pc|dA|pc|c5|pc|d7|pc|d4|pg||
pc|sA|pc|s2|pc|s5|pc|s3|pg||
pc|sK|pc|s9|pc|s7|pc|sT|pg||
pc|s4|pc|sJ|pc|c7|pc|h8|pg||
pc|h6|pc|h9|pc|c8|pc|hT|pg||
pc|s6|pc|sQ|pc|c9|pc|dJ|pg||
pc|d5|pc|dK|pc|cT|pc|d8|pg||
pc|s8|pc|dQ|pc|dT|pc|c3|pg||
pg||
qx|o10|st||md|4SK9HQJT64DJ9872C8,SAJ42HA875D53CK95,SQT86H92DKT64CQJ2,S753HK3DAQCAT7643|sv|b|mb|1C!|mb|p|mb|1D!|an|4+ h|mb|p|mb|2C|mb|p|mb|2S|mb|p|mb|2N|mb|p|mb|3N|mb|p|mb|p|mb|p|pg||
pc|h4|pc|hA|pc|h9|pc|h3|pg||
pc|cK|pc|c2|pc|c3|pc|c8|pg||
pc|c5|pc|cQ|pc|cA|pc|d8|pg||
pc|c6|pc|d7|pc|c9|pc|cJ|pg||
pc|h2|pc|hK|pc|h6|pc|h5|pg||
pc|cT|pc|hQ|pc|h7|pc|s6|pg||
pc|c7|pc|hJ|pc|h8|pc|d6|pg||
pc|c4|pc|d2|pc|s2|pc|d4|pg||
pc|s3|pc|s9|pc|sA|pc|s8|pg||
pc|d3|pc|dT|pc|dA|pc|d9|pg||
pc|s5|pc|sK|pc|s4|pc|sT|pg||
pc|hT|pc|d5|mc|9|pg||
qx|c10|st||md|4SK9HQJT64DJ9872C8,SAJ42HA875D53CK95,SQT86H92DKT64CQJ2,S753HK3DAQCAT7643|sv|b|mb|1C|mb|p|mb|1H|mb|p|mb|2C|mb|p|mb|3N|mb|p|mb|p|mb|p|pg||
pc|d4|pc|dQ|pc|d7|pc|d3|pg||
pc|c3|pc|c8|pc|c9|pc|cQ|pg||
pc|d6|pc|dA|pc|d2|pc|d5|pg||
pc|c4|pc|h4|pc|cK|pc|c2|pg||
pc|c5|pc|cJ|pc|cA|pc|h6|pg||
pc|cT|pc|d8|pc|s2|pc|h2|pg||
pc|c7|pc|dJ|pc|h5|pc|s6|pg||
pc|c6|pc|d9|pc|s4|pc|dT|pg||
pc|h3|pc|hT|pc|hA|pc|h9|pg||
pc|h7|pc|dK|pc|hK|pc|hJ|pg||
pc|s3|pc|s9|pc|sA|pc|s8|pg||
pc|h8|pc|sT|pc|s5|pc|hQ|pg||
pc|sK|pc|sJ|pc|sQ|pc|s7|pg||
pg||