vg|3rd World University Bridge Championships,Round 18-A,I,1,8,Serbia,0,France A,0|
rs|4HS=,4HS=,4SN+1,4SN=,3DS-1,2NN-1,4SN-1,4SN-2,4HS=,3HN=,3NW=,3NW=,5HSx=,4SW-1,6CSx-3,5CS-2|
pn|Z Popovic,D Ancelin,Maksimovic,M Canonne,N Lhuissie,M Jurisic,T Malarme,Gligorijev|pg||
qx|o1|st||md|3SJ53HQJ85DQJ43CQ7,SQ86HT743DK86CT42,SA742HAK92DA72CA6,SKT9H6DT95CKJ9853|sv|o|mb|1C|mb|p|mb|1H|mb|p|mb|2S!|mb|p|mb|3N|mb|p|mb|4H|mb|p|mb|p|mb|p|pg||
pc|s6|pc|sA|pc|s9|pc|s3|pg||
pc|hA|pc|h6|pc|h5|pc|h3|pg||
pc|hK|pc|c8|pc|h8|pc|h4|pg||
pc|s2|pc|sT|pc|sJ|pc|sQ|pg||
pc|h7|pc|h2|pc|c5|pc|hJ|pg||
pc|dJ|pc|d6|pc|d2|pc|d5|pg||
pc|s5|pc|s8|pc|s4|pc|sK|pg||
pc|dT|pc|dQ|pc|dK|pc|dA|pg||
pc|h9|pc|c3|pc|hQ|pc|hT|pg||
pc|d3|pc|d8|pc|d7|pc|d9|pg||
pc|cJ|pc|cQ|pc|c2|pc|c6|pg||
pc|c7|pc|c4|pc|cA|pc|c9|pg||
pc|s7|pc|cK|pc|d4|pc|cT|pg||
pg||
qx|o2|st||md|4SAKJH953DAKQJT6C4,ST954HT7D85CAKJ63,SQ8762HKD974CQ975,S3HAQJ8642D32CT82|sv|n|mb|3H|mb|d|mb|p|mb|3S|mb|p|mb|4D|mb|p|mb|4H!|mb|d|mb|4S|mb|p|mb|p|mb|p|pg||
pc|hA|pc|h3|pc|hT|pc|hK|pg||
pc|hQ|pc|h5|pc|h7|pc|s2|pg||
pc|s6|pc|s3|pc|sA|pc|s4|pg||
pc|sK|pc|s5|pc|s7|pc|d2|pg||
pc|sJ|pc|s9|pc|s8|pc|h2|pg||
pc|d6|pc|d5|pc|d9|pc|d3|pg||
pc|sQ|pc|h4|pc|c4|pc|sT|pg||
mc|11|pg||
qx|o3|st||md|1S9862HAJ764DAQ52C,SKJ5HT953DT9864CK,SAT7HQDK7CJT97643,SQ43HK82DJ3CAQ852|sv|e|mb|1H|mb|p|mb|1N|mb|p|mb|2D|mb|p|mb|3C|mb|p|mb|3D|mb|p|mb|p|mb|p|pg||
pc|dT|pc|dK|pc|d3|pc|d2|pg||
pc|hQ|pc|hK|pc|hA|pc|h5|pg||
pc|h4|pc|h3|pc|d7|pc|h2|pg||
pc|c3|pc|cA|pc|d5|pc|cK|pg||
pc|dA|pc|d4|pc|c4|pc|dJ|pg||
pc|dQ|pc|d6|pc|c6|pc|c2|pg||
pc|hJ|pc|h9|pc|c7|pc|h8|pg||
pc|h7|pc|hT|pc|s7|pc|c5|pg||
pc|d9|pc|sT|pc|s3|pc|s2|pg||
pc|s5|pc|sA|pc|s4|pc|s6|pg||
pc|c9|pc|cQ|mc|8|pg||
qx|o4|st||md|2SAT9HQ96542D75CJ3,S32HK87DK942CQ765,SKJ754HA3DQJT3CA9,SQ86HJTDA86CKT842|sv|b|mb|p|mb|1S|mb|p|mb|2S|mb|p|mb|3D|mb|p|mb|3H|mb|p|mb|4S|mb|p|mb|p|mb|p|pg||
pc|hJ|pc|h2|pc|h7|pc|hA|pg||
pc|h3|pc|hT|pc|hQ|pc|hK|pg||
pc|dK|pc|d3|pc|d8|pc|d5|pg||
pc|d2|pc|dT|pc|dA|pc|d7|pg||
pc|d6|pc|c3|pc|d4|pc|dJ|pg||
pc|cA|pc|c2|pc|cJ|pc|c5|pg||
pc|c9|pc|c4|pc|s9|pc|c6|pg||
pc|sA|pc|s2|pc|s4|pc|s6|pg||
pc|sT|pc|s3|pc|sJ|pc|sQ|pg||
mc|9|pg||
qx|o5|st||md|3ST865HAK84DQT76CK,SK3HJ75DK32CQT986,SAQ9HT962DA84CJ43,SJ742HQ3DJ95CA752|sv|n|mb|1C|mb|p|mb|1H|mb|p|mb|2H|mb|p|mb|4H|mb|p|mb|p|mb|p|pg||
pc|cT|pc|c3|pc|c5|pc|cK|pg||
pc|hA|pc|h5|pc|h2|pc|h3|pg||
pc|hK|pc|h7|pc|h6|pc|hQ|pg||
pc|d6|pc|d2|pc|dA|pc|d5|pg||
pc|d4|pc|d9|pc|dT|pc|dK|pg||
pc|hJ|pc|h9|pc|dJ|pc|h4|pg||
pc|c9|pc|c4|pc|cA|pc|h8|pg||
pc|dQ|pc|d3|pc|d8|pc|c2|pg||
pc|d7|pc|c6|pc|cJ|pc|c7|pg||
pc|sT|pc|sK|pc|sA|pc|s2|pg||
pc|sQ|pc|s4|pc|s5|pc|s3|pg||
pc|hT|pc|s7|pc|s6|pc|c8|pg||
pc|s9|pc|sJ|pc|s8|pc|cQ|pg||
pg||
qx|o6|st||md|4SQJ982HQJ9DJ98C76,S75HK54DAQ52CAQ85,SA43HAT2DT43CJ943,SKT6H8763DK76CKT2|sv|e|mb|p|mb|p|mb|1N|mb|p|mb|3N|mb|p|mb|p|mb|p|pg||
pc|d3|pc|dK|pc|d8|pc|d2|pg||
pc|h3|pc|hJ|pc|hK|pc|hA|pg||
pc|dT|pc|d6|pc|dJ|pc|dA|pg||
pc|h4|pc|h2|pc|h6|pc|h9|pg||
pc|d9|pc|dQ|pc|d4|pc|d7|pg||
pc|d5|pc|s4|pc|c2|pc|s8|pg||
pc|h5|pc|hT|pc|h7|pc|hQ|pg||
pc|c7|pc|c5|pc|cJ|pc|cK|pg||
pc|h8|pc|s2|pc|s5|pc|c3|pg||
pc|cT|pc|c6|pc|cA|pc|c4|pg||
pc|cQ|pc|c9|pc|s6|pc|s9|pg||
pc|c8|pc|s3|pc|sT|pc|sJ|pg||
pc|s7|pc|sA|pc|sK|pc|sQ|pg||
pg||
qx|o7|st||md|1S8HQ9843DAJT94CQ9,SKQJ952HK76DCK754,ST7HAT52DQ652CAT3,SA643HJDK873CJ862|sv|b|mb|2H!|an|5H+4m|mb|2S|mb|4H|mb|4S|mb|p|mb|p|mb|d|mb|p|mb|5H|mb|d|mb|p|mb|p|mb|p|pg||
pc|sK|pc|s7|pc|s6|pc|s8|pg||
pc|sQ|pc|sT|pc|s4|pc|h3|pg||
pc|hQ|pc|hK|pc|hA|pc|hJ|pg||
pc|h2|pc|s3|pc|h9|pc|h6|pg||
pc|h4|pc|h7|pc|hT|pc|sA|pg||
pc|dQ|pc|dK|pc|dA|pc|s2|pg||
pc|dJ|pc|s5|pc|d2|pc|d3|pg||
pc|dT|pc|s9|pc|d6|pc|d7|pg||
pc|d9|pc|sJ|pc|d5|pc|d8|pg||
pc|d4|pc|c4|pc|c3|pc|c2|pg||
pc|cQ|pc|cK|pc|cA|pc|c6|pg||
pc|h5|pc|c8|pc|h8|pc|c5|pg||
pc|c9|pc|c7|pc|cT|pc|cJ|pg||
pg||
qx|o8|st||md|2SJT2HT4DA87CQT862,SAKQ8HKJ7653DKJC9,SHQ9DQ96543CAJ543,S976543HA82DT2CK7|sv|o|mb|1H|mb|2N!|mb|3H|mb|5C|mb|5H|mb|6C|mb|d|mb|p|mb|p|mb|p|pg||
pc|sK|pc|c3|pc|s7|pc|s2|pg||
pc|d3|pc|d2|pc|dA|pc|dJ|pg||
pc|cQ|pc|c9|pc|c4|pc|cK|pg||
pc|hA|pc|hT|pc|h7|pc|h9|pg||
pc|h8|pc|h4|pc|hK|pc|hQ|pg||
pc|s8|pc|cA|pc|s3|pc|sT|pg||
pc|c5|pc|c7|pc|cT|pc|h3|pg||
mc|9|pg||