vg|3rd World University Bridge Championship,Round 3A,I,1,8,Thailand,0,Poland A,0|
rs|3CN=,3NEx-4,3NS-1,3NSx-1,2SE+2,4SE=,2SS=,1NS=,2HE=,3NS-1,3NN+1,4HS=,1NSx-1,1NEx=,4HN-1,4HN-1|
pn|Tunyaset N,Buras KJ,Thotongkam,Araszkiewi,South,West,North,East|pg||
qx|o1|st||md|3SAKQ6H52DA9642C85,SJ84HJT9763DQ5CKQ,S72HQ84DJ8CAJ9764,ST953HAKDKT73CT32|sv|o|mb|p|mb|p|mb|1D|mb|2H|mb|3C|mb|p|mb|p|mb|p|pg||
pc|hK|pc|h2|pc|h7|pc|h4|pg||
pc|hA|pc|h5|pc|h6|pc|h8|pg||
pc|d3|pc|dA|pc|d5|pc|d8|pg||
pc|sA|pc|s4|pc|s7|pc|s3|pg||
pc|sK|pc|s8|pc|s2|pc|s5|pg||
pc|sQ|pc|sJ|pc|dJ|pc|s9|pg||
pc|c5|pc|cK|pc|cA|pc|c2|pg||
pc|hQ|pc|cT|pc|s6|pc|h3|pg||
pc|dK|pc|d2|pc|dQ|pc|c4|pg||
pc|c6|pc|c3|pc|c8|pc|cQ|pg||
mc|9|pg||
qx|o2|st||md|4S943H94DAQ874CAQ3,SKJT6HT82DJ3CKJ52,SA8HAQ65DK95CT864,SQ752HKJ73DT62C97|sv|n|mb|p|mb|1D|mb|p|mb|1H|mb|p|mb|1N|mb|p|mb|3N|mb|p|mb|p|mb|p|pg||
pc|sT|pc|sA|pc|s2|pc|s3|pg||
pc|d5|pc|d2|pc|dA|pc|d3|pg||
pc|d4|pc|dJ|pc|dK|pc|d6|pg||
pc|d9|pc|dT|pc|dQ|pc|c2|pg||
pc|d8|pc|h8|pc|h5|pc|c7|pg||
pc|d7|pc|h2|pc|c4|pc|h3|pg||
pc|h4|pc|hT|pc|hQ|pc|hK|pg||
pc|s5|pc|s4|pc|sJ|pc|s8|pg||
pc|sK|pc|c6|pc|s7|pc|s9|pg||
pc|s6|pc|c8|pc|sQ|pc|c3|pg||
pc|c9|pc|cQ|pc|cK|pc|cT|pg||
pc|c5|pc|h6|pc|h7|mc|8|pg||
qx|o3|st||md|1SQ97HQJ54DK76C963,SA64HA863DJT5CAJ4,ST5HKT9DQ2CKQT852,SKJ832H72DA9843C7|sv|e|mb|p|mb|1C!|mb|p|mb|1S|mb|p|mb|1N|mb|p|mb|2S|mb|p|mb|p|mb|p|pg||
pc|c6|pc|cA|pc|cT|pc|c7|pg||
pc|c4|pc|cQ|pc|s2|pc|c3|pg||
pc|h2|pc|h4|pc|hA|pc|h9|pg||
pc|cJ|pc|cK|pc|s3|pc|c9|pg||
pc|h7|pc|hJ|pc|h3|pc|hT|pg||
pc|d6|pc|d5|pc|dQ|pc|dA|pg||
pc|d3|pc|dK|pc|dT|pc|d2|pg||
pc|d7|pc|dJ|pc|s5|pc|d4|pg||
pc|hK|pc|sJ|pc|h5|pc|h6|pg||
pc|s8|pc|s7|pc|sA|pc|sT|pg||
pc|s4|pc|c2|pc|sK|pc|s9|pg||
pc|d8|pc|hQ|pc|s6|pc|c5|pg||
mc|10|pg||
qx|o4|st||md|2S9643HAJ4DQ65CA54,SJT7HK763DJ2CKQJ7,SAK85HT9DAT3C9862,SQ2HQ852DK9874CT3|sv|b|mb|p|mb|1C|mb|p|mb|1S|mb|p|mb|2S|mb|p|mb|p|mb|p|pg||
pc|cK|pc|c2|pc|c3|pc|cA|pg||
pc|s3|pc|s7|pc|sA|pc|s2|pg||
pc|sK|pc|sQ|pc|s4|pc|sT|pg||
pc|hT|pc|h2|pc|h4|pc|hK|pg||
pc|sJ|pc|s5|pc|d9|pc|s9|pg||
pc|h3|pc|h9|pc|hQ|pc|hA|pg||
pc|hJ|pc|h6|pc|d3|pc|h5|pg||
pc|d5|pc|d2|pc|dT|pc|dK|pg||
mc|8|pg||
qx|o5|st||md|3SJ43HT5DAKQCKQ986,SAQ97HKQ64D8652C4,SK652HJ92DT4CA753,ST8HA873DJ973CJT2|sv|n|mb|p|mb|p|mb|1N|mb|2C!|mb|p|mb|2H|mb|p|mb|p|mb|p|pg||
pc|dA|pc|d2|pc|dT|pc|d9|pg||
pc|dK|pc|d5|pc|d4|pc|d7|pg||
pc|h5|pc|hK|pc|h2|pc|h3|pg||
pc|c4|pc|cA|pc|c2|pc|c8|pg||
pc|h9|pc|h7|pc|hT|pc|hQ|pg||
pc|d6|pc|hJ|pc|d3|pc|dQ|pg||
pc|c3|pc|cT|pc|cQ|pc|h4|pg||
pc|d8|pc|c5|pc|dJ|pc|s3|pg||
pc|sT|pc|s4|pc|sQ|pc|sK|pg||
mc|8|pg||
qx|o6|st||md|4SQJ4HAKJ832D975C7,ST765HQ654DK82CK9,SAK82HDQ43CAQJT53,S93HT97DAJT6C8642|sv|e|mb|p|mb|1H|mb|p|mb|1S|mb|p|mb|2H|mb|p|mb|3C|mb|p|mb|3S|mb|p|mb|3N|mb|p|mb|p|mb|p|pg||
pc|h9|pc|hA|pc|h4|pc|c3|pg||
pc|c7|pc|c9|pc|cT|pc|c4|pg||
pc|cJ|pc|c2|pc|h2|pc|cK|pg||
pc|d8|pc|d3|pc|dT|pc|d5|pg||
pc|c6|pc|d7|pc|h5|pc|cQ|pg||
pc|cA|pc|c8|pc|d9|pc|s5|pg||
pc|s2|pc|s3|pc|sQ|pc|s6|pg||
pc|hK|pc|h6|pc|d4|pc|h7|pg||
pc|sJ|pc|s7|pc|s8|pc|s9|pg||
pc|s4|pc|sT|pc|sA|pc|d6|pg||
pc|sK|pc|hT|pc|h3|pc|d2|pg||
pc|c5|pc|dJ|pc|h8|pc|hQ|pg||
pc|dQ|pc|dA|pc|hJ|pc|dK|pg||
pg||
qx|o7|st||md|1SJ862HAQJTDT853C5,SQ9H9763DK76CJ963,S53HK52DQ42CAQ874,SAKT74H84DAJ9CKT2|sv|b|mb|p|mb|p|mb|1C|mb|1S|mb|1N|mb|p|mb|p|mb|d|mb|p|mb|p|mb|p|pg||
pc|sQ|pc|s3|pc|s4|pc|s6|pg||
pc|s9|pc|s5|pc|sK|pc|s2|pg||
pc|sA|pc|s8|pc|h3|pc|h2|pg||
pc|s7|pc|sJ|pc|h7|pc|c4|pg||
pc|hT|pc|h6|pc|hK|pc|h4|pg||
pc|h5|pc|h8|pc|hA|pc|h9|pg||
pc|hQ|pc|d7|pc|c7|pc|c2|pg||
pc|hJ|pc|c3|pc|c8|pc|d9|pg||
pc|dT|pc|dK|pc|d2|pc|dJ|pg||
pc|c6|pc|cQ|pc|cK|pc|c5|pg||
pc|sT|pc|d3|pc|c9|pc|d4|pg||
pc|dA|pc|d5|pc|d6|pc|dQ|pg||
pc|cT|pc|d8|pc|cJ|pc|cA|pg||
pg||
qx|o8|st||md|2SQ9HA765DQ4CJ6432,S84H2DAK9652CKT95,SAJ63HKQ843DJ7CA7,SKT752HJT9DT83CQ8|sv|o|mb|1D|mb|1H|mb|d!|mb|2H|mb|p|mb|2N!|mb|p|mb|4H|mb|p|mb|p|mb|p|pg||
pc|d8|pc|d4|pc|dK|pc|dJ|pg||
pc|dA|pc|d7|pc|d3|pc|dQ|pg||
pc|s4|pc|sA|pc|s5|pc|s9|pg||
pc|hQ|pc|h9|pc|h5|pc|h2|pg||
pc|h3|pc|hT|pc|hA|pc|d2|pg||
pc|h6|pc|d6|pc|hK|pc|hJ|pg||
pc|s3|pc|sK|pc|sQ|pc|s8|pg||
pc|cQ|pc|c2|pc|c5|pc|cA|pg||
pc|c7|pc|c8|mc|9|pg||