vg|3rd World University Bridge Championships,Round 15-A,I,1,8,France A,0,Thailand,0|
rs|2SS+3,2SS+1,1NE+3,2HE+1,2CE+1,4HN=,1NE=,1NE=,1NN=,1NN=,3HS-2,3HS-3,1NNx+3,2HE+2,3DNx-3,2CSx-1|
pn|Lhuissier,T Tunyaset,T Malarme,Sookkasem,Panichkraj,D Ancelin,N Tunyaset,M Canonne|pg||
qx|o1|st||md|3SAT642HAQ4DQ86C64,SQ75H7653DAJ92CJ8,S983HT9DKT54CA732,SKJHKJ82D73CKQT95|sv|o|mb|p|mb|1C|mb|1S|mb|p|mb|2S|mb|p|mb|p|mb|p|pg||
pc|h7|pc|h9|pc|hK|pc|hA|pg||
pc|hQ|pc|h6|pc|hT|pc|h2|pg||
pc|h4|pc|h5|pc|s3|pc|h8|pg||
pc|s8|pc|sK|pc|sA|pc|s5|pg||
pc|s2|pc|s7|pc|s9|pc|sJ|pg||
pc|hJ|pc|s4|pc|h3|pc|c2|pg||
pc|d8|pc|dA|pc|d4|pc|d3|pg||
mc|11|pg||
qx|o2|st||md|4SAKTHJ952DT4CAKT7,SJ764H876DA9875CQ,SQ532HT4DJ3C86432,S98HAKQ3DKQ62CJ95|sv|n|mb|1N|mb|p|mb|p|mb|p|pg||
pc|cA|pc|cQ|pc|c2|pc|c5|pg||
pc|cK|pc|h6|pc|c3|pc|c9|pg||
pc|sA|pc|s4|pc|s2|pc|s8|pg||
pc|cT|pc|h7|pc|c4|pc|cJ|pg||
pc|dK|pc|d4|pc|d5|pc|d3|pg||
pc|dQ|pc|dT|pc|d7|pc|dJ|pg||
pc|d6|pc|h2|pc|dA|pc|h4|pg||
pc|d9|pc|s3|pc|d2|pc|sT|pg||
pc|d8|pc|c6|pc|s9|pc|c7|pg||
pc|h8|pc|hT|pc|hA|mc|10|pg||
qx|o3|st||md|1SA2HQ863DT864CAK7,SKQ6H2DAKQ52CJT53,SJT874HAJ974DC842,S953HKT5DJ973CQ96|sv|e|mb|1D|mb|p|mb|1S|mb|p|mb|1N|mb|d|mb|p|mb|2C|mb|p|mb|p|mb|p|pg||
pc|cA|pc|c3|pc|c4|pc|c6|pg||
pc|h6|pc|h2|pc|hA|pc|h5|pg||
pc|s4|pc|s3|pc|sA|pc|s6|pg||
pc|s2|pc|sQ|pc|s7|pc|s5|pg||
pc|c5|pc|c2|pc|cQ|pc|cK|pg||
pc|c7|mc|9|pg||
qx|o4|st||md|2SK82HA4DA542C9865,SQ943HT65DKT63C74,ST5HJ8732DQJCAJT3,SAJ76HKQ9D987CKQ2|sv|b|mb|p|mb|p|mb|1N|mb|p|mb|p|mb|p|pg||
pc|c8|pc|c4|pc|cA|pc|c2|pg||
pc|h2|pc|hK|pc|hA|pc|h5|pg||
pc|h4|pc|hT|pc|hJ|pc|hQ|pg||
pc|sA|pc|s2|pc|s3|pc|s5|pg||
pc|s6|pc|s8|pc|sQ|pc|sT|pg||
pc|s4|pc|c3|pc|sJ|pc|sK|pg||
pc|d5|pc|d3|pc|dQ|pc|d7|pg||
pc|h8|pc|h9|pc|d2|pc|h6|pg||
pc|cK|pc|c5|pc|c7|pc|cT|pg||
pc|cQ|pc|c6|pc|d6|pc|cJ|pg||
pc|s7|mc|7|pg||
qx|o5|st||md|3SJT2H832DQ53CQJ72,SK87HKT7D984CK843,SA53HQJ95DAKJTCT5,SQ964HA64D762CA96|sv|n|mb|1N|mb|p|mb|p|mb|p|pg||
pc|s4|pc|sJ|pc|sK|pc|sA|pg||
pc|cT|pc|c6|pc|c2|pc|c3|pg||
pc|dT|pc|d2|pc|dQ|pc|d4|pg||
pc|h2|pc|h7|pc|hQ|pc|hA|pg||
pc|s6|pc|sT|pc|s8|pc|s3|pg||
pc|d3|pc|d9|pc|dJ|pc|d6|pg||
pc|dK|pc|d7|pc|d5|pc|d8|pg||
pc|dA|pc|h4|pc|s2|pc|c4|pg||
pc|c5|pc|c9|pc|cQ|pc|cK|pg||
pc|s7|pc|s5|pc|sQ|pc|h3|pg||
pc|cA|pc|c7|pc|c8|pc|h5|pg||
pc|s9|pc|h8|pc|hT|pc|h9|pg||
pc|h6|pc|cJ|pc|hK|pc|hJ|pg||
pg||
qx|o6|st||md|4ST86HAKJ64D942CK4,S7H873DK53CAJT932,SQ43HQT2DJT86CQ76,SAKJ952H95DAQ7C85|sv|e|mb|1S|mb|2H|mb|p|mb|p|mb|2S|mb|p|mb|3C|mb|3H|mb|p|mb|p|mb|p|pg||
pc|s7|pc|s3|pc|sJ|pc|s6|pg||
pc|sA|pc|s8|pc|c3|pc|s4|pg||
pc|sK|pc|sT|pc|d5|pc|sQ|pg||
pc|dA|pc|d2|pc|d3|pc|d6|pg||
pc|d7|pc|d4|pc|dK|pc|d8|pg||
pc|cA|pc|c6|pc|c5|pc|c4|pg||
pc|cJ|pc|c7|pc|c8|pc|cK|pg||
pc|hA|pc|h3|pc|h2|pc|h5|pg||
pc|h4|pc|h7|pc|hT|pc|h9|pg||
pc|hQ|pc|s2|pc|h6|pc|h8|pg||
pc|cQ|pc|s5|pc|d9|pc|c2|pg||
mc|7|pg||
qx|o7|st||md|1ST74H2DAQJ863C653,SA82HJ875D42CQT42,SQ93HQ4DKT95CAKJ7,SKJ65HAKT963D7C98|sv|b|mb|p|mb|p|mb|1N|mb|d!|mb|p|mb|p|mb|p|pg||
pc|h9|pc|h2|pc|hJ|pc|hQ|pg||
pc|cA|pc|c8|pc|c3|pc|c2|pg||
pc|dK|pc|d7|pc|d3|pc|d2|pg||
pc|dT|pc|c9|pc|d6|pc|d4|pg||
pc|d9|pc|sJ|pc|d8|pc|h8|pg||
pc|d5|pc|s5|pc|dA|pc|s2|pg||
pc|dQ|pc|s8|pc|h4|pc|hA|pg||
pc|dJ|pc|h5|pc|s3|pc|h3|pg||
pc|c5|pc|c4|pc|cJ|pc|h6|pg||
pc|cK|pc|s6|pc|c6|pc|cT|pg||
mc|10|pg||
qx|o8|st||md|2SQ8HAJDA864CJT874,SAT4HT9DJT95CAKQ3,SK732HK8432D732C2,SJ965HQ765DKQC965|sv|o|mb|1D|mb|1H|mb|p|mb|2N|mb|p|mb|p|mb|d|mb|p|mb|p|mb|r|mb|p|mb|3C|mb|p|mb|p|mb|d|mb|p|mb|p|mb|3D|mb|d|mb|p|mb|p|mb|p|pg||
pc|dK|pc|d4|pc|d5|pc|d3|pg||
pc|dQ|pc|d6|pc|d9|pc|d2|pg||
pc|h5|pc|hJ|pc|h9|pc|h2|pg||
pc|cJ|pc|cQ|pc|c2|pc|c5|pg||
pc|dJ|pc|d7|pc|c6|pc|dA|pg||
pc|hA|pc|hT|pc|h3|pc|h7|pg||
pc|d8|pc|dT|pc|s2|pc|c9|pg||
pc|cA|pc|h4|pc|s5|pc|c4|pg||
pc|s4|pc|s3|pc|s9|pc|sQ|pg||
pc|s8|pc|sA|pc|s7|pc|s6|pg||
pc|cK|pc|h8|pc|sJ|pc|c7|pg||
pc|sT|pc|sK|pc|h6|pc|c8|pg||
pc|hK|pc|hQ|pc|cT|pc|c3|pg||
pg||